YouTube ID	Title
LhTS_RSQxw4	True Stories
E5Y4rNBCLaU	The 11th Hour
D-In3mEfBxg	The Wind and the Lion
Ow6F8KUZ_qo	Crossing Delancey
kFT2kd7ulN0	The Bonfire of the Vanities
9J8XaQv9A0E	Oh, God!
lgwSjaVkQXU	Deal of the Century
8pLZisKo3pc	Hollywoodland
LWkW64ydcAM	Wet Hot American Summer
NlNPsO4VjSI	Beguiled, The
s2iAPJITLbU	Inside Man ('06)
qwd9nl6OYwk	Monsieur Lazhar
OJGPAGoSNdM	Mutiny on the Bounty
jAyg_ENvHzc	The Science of Sleep
kdcpucIogK4	If Beale Street Could Talk
j7qKG4Vc5Tk	Shaun of the Dead
X42yOL5Ah4E	Murder in the First
31_vHHPNdGg	Cats
_l5Uaqw4x6E	Fletch Lives
mHtIEP48_xw	The Accidental Tourist
LSiNyASh1mI	Antwone Fisher
PHD42R6jzRE	Dr. Dolittle
maaU86zXNR8	The Commitments
iSXohhur5Y4	A Walk In The Clouds
iyo17WToiiU	History of the World, Part I
jINKckq_ua0	The Year of Living Dangerously
sC_1LEdmUII	City Heat with Clint Eastwood and Burt Reynolds
dJoO6pOv6Ps	SubUrbia
WVGU5OyYPY0	Don't Be A Menace to South Central While Drinking Your Juice in the Hood
Tpp1sg-U6eo	All The King's Men
TE0bQ4Fjbms	Waiting for Guffman
1Dd0JDQkG50	Poltergeist II: The Other Side
b3hzMz2hp8U	Max
foutPlFx3MY	Michael Collins
SeUvyzo6k5c	Sniper
mVG15XDVO0I	Red Rock West
iQJUkASxCuA	American Hustle
XP2ZYDGHptQ	Away We Go
M2E-7PPJ26c	The Good Thief
3fNxiN80YGk	Down and Out in Beverly Hills
6_BUIFi3YHE	Backdraft
cKhX3YIEp1I	The Expendables
-wAtJxFOCOU	Escape From Alcatraz
TMUaY609iYc	Happy Gilmore
wC7G4Ghj-1k	The Warriors
EzNcyxGicp4	Crazy, Stupid, Love
1VsvuaUl4jI	The Gods Must Be Crazy II
PiFlujEF78Y	The Sum of All Fears
nB-I8i6y6II	Prometheus
wJE7MnbQEjE	Richard Pryor Live On The Sunset Strip
bri9qLk1CaU	The Saint
9F5ijFc5O9Y	Indecent Proposal
w7IoRUxh_uo	What Lies Beneath
D0GrKaMgKpc	Pretty in Pink
nj6Ol3ej5y0	Hearts Of Darkness
jZxNxqnCu-M	John Carpenter's Escape From L.A.
2qDxZSV09GQ	Ladyhawke
vUSDQTEjdyA	The Scarlet Letter
8QCX2__UgrU	Fletch
fF4_7ePNvU0	The Electric Horseman
1eSaTgOgSqc	Sleepy Hollow
yVUIRcWTq0g	American Gangster
-Ucv-mN0IrI	Swing Kids
k5k5C26l2os	Mamma Mia: Here We Go Again!
a5ZIiWNBRNo	The World's End
VrO5KdyrEdw	Amistad
vBzxrvTl-ik	Lucy
uHq1te_hoMY	Serpico
C1vxrfmHMSE	Jimmy Carter
o0sT6Uo1Mx4	Lady For A Day
fd5M2eMO_ro	Haywire
XSMmBLHdOkA	Jennifer Connelly in PHENOMENA
MTIWVUpbU9g	Head (ft. The Monkees)
GP0jou_MTQU	Darkest Hour
a0ILMUMtzos	The Autobiography of Miss Jane Pittman
Fg6JGN6R8a8	The Beastmaster
JQ5DOnfzAZk	Until The Light Takes Us
lUd9pmKSatg	Who is Harry Nilsson (And Why is Everybody Talkin' About Him)?
FGhTDIFDnIs	Reign Of Terror
YbEQ7acb0IE	SiCKO
JW_VCjckSD8	Crime And Punishment
x5WLVlJjgSE	Cary Grant And Audrey Hepburn In HD
6w3iElemSYI	Limitless
XL8aEqVLy9s	Far from Heaven
o-gxZkHxM-4	Jesus Christ Superstar
Hl2FkvyN3-s	Rambo: First Blood II
R5_KF3LyF4o	Afterglow
7PMTODz9QDs	Lionheart (2-Disc Special Edition)
nOtnhmvNpgc	Henry V
Xh8P4MIaZBA	Post World War II Sci-Fi
guE0Qd8BRw0	Hundreds of Beavers
6OpG4Dyl6ok	Lone Star
XtCgph3lyCI	Someone To Watch Over Me
2g3L2Bi-QpA	Divide and Conquer: The Story of Roger Ailes
7tx9B53s5XU	Enron: The Smartest Guys In the Room
AjT-BAmaiN4	D.O.A.: A Right Of Passage (Special Edition)
aYde8h1YKvs	Leaning into the Wind
Ie25uLsqbnM	All The Real Girls
VS9J_ETXJQs	Silent Rage (ft. Chuck Norris)
NQabG6_hJLQ	Tim's Vermeer
bxTfUAvaIMw	Some Like It Hot
qs-ZH0g6oLA	Born Yesterday
jGAOL8TdNA4	Poltergeist III
fEsca_3P2VA	Annie Hall
Sy5-bdVTtK0	Nomad: In the Footsteps of Bruce Chatwin
yjPxL5w3OOU	The Choice
pUPXZoR1QjA	Khartoum
CJ6qz-fqiFQ	Curse of the Golden Flower
TdqyYmHze-A	The Comic (ft. Dick Van Dyke)
GW5AjXOWo6E	The 'Burbs
RCalnALx1bM	The Notorious Landlady
5B8zyQ0oeGQ	Forks Over Knives
7iQAhqjqds4	The Exorcist III: Legion (Director's Cut)
rlHFmKzJRX4	The Cranes Are Flying
CvT6Run88zk	The Story of Film: A New Generation
II7KxOLsHhg	Chino
sJqhBjL_RR8	Dinner Rush
S3LD2zpp7Vc	The Limey
_cTVIw_tyAo	The Black Room
WqMjHGzq1K8	Gone in 60 Seconds
yOi77-_Fgys	Sunset Park
xXIwfvPFeCw	Cannonball
wUNXADodGwc	Mr. Sardonicus
SBWpi5pGGMw	Gordon Lightfoot: If You Could Read my Mind
6z53IxNH2l8	Diana Vreeland: The Eye Has To Travel
xUWQ6RfjUwQ	Just One of The Guys
1x8EnU6L404	The Black Room
YH_b8DSxM2g	Cold Mountain (TV Edit)
0CPafskRMVM	Trading Places (TV Version)
U8JOLjktORE	Saturday Night Fever (TV Version)
2guv3X93n7E	Noah's Ark
T40nO2YQfNg	The Dark Half
feSpMh0qPEs	Doc Hollywood
Tk6btg4Mepg	Harley Davidson And The Marlboro Man
zkXWffqyopE	Fried Green Tomatoes
DhZsWkR8b-8	Psychomania a.k.a. The Death Wheelers
L-IjCaEMcK0	Paprika
RtfeyQVx_Uw	Compa√±eros   Western    Corbucci
kOd-sDxrIDc	A Woman Called Moses
Ivea-O8sn0k	Hercules In New York
s2u2aOa2K0Q	Cadence
h4SaNRYJaJg	Men in War
vBAL7JBtHK0	Croupier
v-i8lil_VxU	Never Cry Wolf
Q9zZNZDUtIw	Anna and the King
4ZF60rn1hBY	The Innocents
ndNXYEZZq2Q	Birth of the Cinema
2a8mbN1bQsQ	BEACH RED
tQyN2XiBZJA	Horror Express
F0WUJKo-vY4	Mr. Bug Goes to Town
qRNRw017V6g	The Emperor Jones
dr_n7x9Gfsc	Flower Drum Song
uLY_-yDwu-8	The Story Of G.I. Joe
ZOxCAnfhypE	Crimson Peak
LZSiA40Cmmk	The Train
VWDkY5ok0S0	Psycho 2
iygMsVkxmJY	Psycho IV: The Beginning
rf857KH2zz8	Only You
qiExr2zuydE	Zappa
STwBRaO1WiU	Bring It On
s7O7azUQaOI	Psycho
0oG336ah9hI	Street Scene
WbFU4HbifKg	The Gate
wAbvE-g8ReI	Jimi: All Is By My Side
UUPA-p0M9N8	Wish Upon A Star
mXN0wNXM8O4	Murder on a Sunday Morning
FhNWjiXREkk	Guys And Dolls
DdZa_7ow8UE	THE BEAUTIFUL PEOPLE! Bright Young Things
CqWoanmJF6g	La notte
NZMjLPQxvyU	Bulldog Drummond
69rsJh39iLU	Double Dragon
85rD1E9UWXU	Night Moves
VXhnEqEH24c	Total Recall
56jGq9nsLfI	Dark Horse
B7RsU9_DTfU	Knightriders
mApuU9nDXLI	Disco Godfather
-JLtJkW-KmQ	Grizzly
3D-eADV_yX0	Gideon Of Scotland Yard
eWxHMkMez-U	Affair In Trinidad
1_TCYah9Qy8	Voyage Of The Rock Aliens
JIEqXUHewMA	Blue Collar Comedy Tour: One for the Road
BjdB5MlM-nQ	JCVD [English-Language Version]
9YcPkigDdqw	The Fanatic
9Ox_Bn-p_uE	Wing Chun
DmYppJbFZK4	Sirocco
_OajH-axo_U	All the Little Animals
fNl6zpzSXfc	Fire Down Below
VjofX9ASgc8	Queen Bee
UvLmPT339Rg	Jubal
Se1A8lxyH4I	Going Clear: Scientology and the Prison of Belief
4XMRm9igLGo	The Dark Crystal
lL_Q0VtrTxU	Labyrinth
iVj8rtpEgVs	Death On The Nile
N78eiAx8f14	Raise The Titanic
NoVjQqllrlw	Demons 2
yrFGw4vj9d4	Ball of Fire
dwhqiJYlifk	Miss Firecracker
2iaTadC0VYQ	Demons
n5NFhhO7LGM	Minnesota Clay
FyLeDMF2Ot8	Lured
62XLMoi1VTs	Dodgeball: A True Underdog Story
LhArTFocIb0	Frankenstein Meets The Wolfman
G2gpBTOvCxo	The Yes Men
oGjPhV2Hn_I	Yentl
sDarp2tvdQo	Red
pWT3USP3UA8	The Thirty-Nine Steps
-uhTlu7Ps0k	It! The Terror From Beyond Space
i6zGao2S-zs	Spartacus
-mqcn5M0ktA	LBJ
v21lQ449T3Y	The Ascent
L3lYUU0M0yo	Sweet and Lowdown
e89gY3yE_XU	Small Time Crooks
BU2u7fFyDD8	Mighty Aphrodite
--YoL6LlhcU	A Scandal In Paris
Zg2-FafPx0k	Nosferatu The Vampyre [English-Language Version]
KYJ9rrRCpHM	Everyone Says I Love You
Kk3fBR46lQQ	Bullets Over Broadway
aa0lp22eSj8	The Curse of the Jade Scorpion
jXHMGdHOF94	Match Point
HBBdZ9jctto	Hollywood Ending
xth2wvp8b1k	Foreign Correspondent
e_zwoLQ9Wdg	Land Of Silence And Darkness
Q9VBGElYVKk	Even Dwarfs Started Small
0YNCHlQhSkI	Happy People: A Year in the Taiga
F6fEKVIa4AQ	Antarctica: A Year on Ice
MdDaQxHq4VE	Ballad Of The Little Soldier
lR3ueMCnZr4	The Adventures of the Wilderness Family
lJZYIv1AiKs	Hamlet
X8j0YqglkO0	Anything Else
3sqzEhbtIpY	Stagecoach
GO-lBMk7ifw	Twister
SuyVxWNZ52M	Hopscotch
XLqe5Ficu6g	Coonskin
xHP5Gcb6mJE	The Philadelphia Experiment
aHxj1jD60KM	Girls Just Want To Have Fun
wJogk28uCAw	The Bear
SsC7tTwSMVE	The Decline Of Western Civilization, Part II: The Metal Years
MyqUORteYZg	The Decline Of Western Civilization, Part III
GdGUobvBlw8	Bats
ARCCHg6QvDQ	The Boy in the Plastic Bubble
qqAuJfqoBgw	Circus Of Horrors
gDsRvxV-B4M	Rock 'N' Roll High School
p8gnWo6gtQk	The Painted Veil
Ah28qap5Row	Quigley Down Under
QQmO8wktuF8	The Hudsucker Proxy
06RHwal8WMk	Casino Royale
IYf9LCdprDA	Michael
ky32ti4M9Ls	The Cabinet Of Dr Caligari
CegnoMDqFgo	A Hero Ain't Nothin' but a Sandwich
De6pXg9J_kA	The Eagle Has Landed
5wGdCKQYRmo	Vernon, Florida
FlJQKmaPsYg	God Told Me To
ystds4_bpWU	Thin Blue Line, The
-GTDP31UbzM	My Name Is Nobody
Y8Wukx-UTGs	Kurt Cobain: About A Son
Ht_as4XJHIQ	Lost in La Mancha
ezz1O_wkhcE	Flight of the Red Balloon
6S9BKYKQM8E	Lessons Of Darkness
Kuwu30JAyO0	Heathers
4EoiGLjH-zs	Joan Rivers: A Piece of Work
HTAxlZytMmE	18 Again!
9O9RIMv9YeQ	Flowers in the Attic
5Q8fE3TLg0A	Gates of Heaven
Nnv4W5zfQ2I	Sounder
eh3M2ZZ-eus	Brother's Keeper
pJm63X0cpBo	South Pacific
waIxjDjzPko	The New Corporation: The Unfortunately Necessary Sequel
Qbl89-pUyuQ	Another Round
rRVtVKQ7dTo	Boys on the Side
aZ0ERILB248	Black Christmas
qyBGZXrJH5M	Affliction
kZuN-JMuy_Y	The Walking Hills
RAoHMhtrXtM	The Man In The Iron Mask
NB8lY4kqMMg	On Golden Pond
ohcsQBGCn_w	The Crimson Kimono
73Dn_-eATWQ	Psycho
H7syOmKqn7s	Legend
axLFEKxUTYo	Jiro Dreams of Sushi
ikPrwU_m3b8	Disco Godfather
Nb-sWuKDJAk	Taxi To The Dark Side [Broadcast Edit]
rcCYsN9bEp8	Deadlier Than The Male
pHY2LvTFwaA	I Bury the Living (Horror
LHzxdA5coOQ	Places In The Heart
Zo2-Ys6aqLw	The Tragedy Of Macbeth
bZgamryjH-o	Avalon
-MhXWJl-CZM	You Can't Take It With You
7vLgKhiUrTs	The Legend of Billie Jean
orCQFC7Dy54	The Company
3g60SZJxEXQ	Manhattan Murder Mystery
uLmwcmsQFKE	Chances Are
XXBqhDz4vm4	My Life
ukH7mflq8UE	I Love You To Death
Cb_GfGYFi3M	Nuclear Now
ucOtZEu-SKw	Where's My Roy Cohn?
UwfslZWSt4c	American Pop
69Lm1A25KeY	Butterflies Are Free
oVLq2cdOw1I	Murder By Death
9Ac9eWkEh0U	The Principal
gAtScKmdxmE	Swept From The Sea
EU6Iluyb0kY	Groove
DDezey2E-jI	I Walk The Line
T2GByAxJp0Y	Greenfingers
rg_93AVD8Uc	For Keeps
Sg5paJWxvQI	Neighbors
eengqOpIgfw	Breakout
kbHgfCwXqVU	Mirrormask
NpB5EgZ26Mo	Stay Tuned
ifKgKeEgLjw	Walk, Don't Run
6lGzhEtRvmI	Hawk The Slayer
KO2TziSjQkE	The Man Who Laughs
wSZmT78fAGk	The Fortune Cookie
jNgj3lMza40	Days of Thunder
pHf8Dh97Qqc	In The Heat Of The Night
ZCEdJTjuu2s	Rain Man
bPFqGM4i3gE	The Million Pound Note
7ov-ZpPNOFE	The Lady Vanishes
Ivxrdt2LAwM	The Medusa Touch
eg4DWvPw8OU	The Man In The Iron Mask
gaxb159hRsY	Bird of Paradise (Adventure
mqw03ZyllZA	Man Friday
QTrBrDWxjg8	Intolerance: Love's Struggle Throughout the Ages (1916 Drama, History) D.W. Griffith
up12Sn0hSdU	Two Mules for Sister Sara
44rFOcuDDYs	Anything Else
F1pgjaNcKqM	Death Of A Salesman
UnHK6ofg1i0	Pride & Prejudice
vUbi69p-WMA	The 39 Steps
uz0Nrj3kdB8	Pacific Heights [Broadcast Edit]
r98riGAdaVE	The Birds
4tYVgQ3KUeU	Rain (Un-cut/Restored)
taTqo6xNRwY	The Diary Of Anne Frank
Jakf-B3FXKY	A Bay of Blood
mOCFu1r2lR4	Death of a Cheerleader
Cf0zOaJIM2k	The Super
jV68rYZ0YLE	Capturing Reality: The Art of Documentary
IvGpXIJzt2Y	Dr. Giggles [Broadcast Edit]
jxwX4u_2gKg	The Man With The Golden Arm
UReFfcCXKws	Dodsworth
a3SMdxvNyqE	Orphans Of The Storm
hTa8pvyyb7o	Immediate Family
eFjvindRTBk	Zulu Dawn
I5pG1wbRKOg	Steamboat Willie
qHIxyDin-og	Child's Play
m96AGt7Ymzs	Miss Congeniality
FgJixBLTlwM	Somewhere in Time
jn2q8zBYl1I	Man Of A Thousand Faces
Gzk0f9xuIFg	Once Upon a Time in the West
uvp4XVnOLu4	Wrestling Ernest Hemingway
9hK5KmLESd0	Little Giants
azkcwid8r1U	B.B. King
j6qgqDOZWQo	The 47 Ronin
4N5Xe0LEKrE	Wild Geese
syX2fObQOIU	Robinson Crusoe
CZk_YoIuRJw	The Chosen
mxTpvMNDCdg	Chopping Mall
Y82V3e_yYbE	The Outlaw
awO_4v6B0O8	Detachment
tpr_EzPif3w	The Ongoing War Of Crips & Bloods
V-5XGKQXd1s	The Private Life Of Henry VIII
b6kMpenpQGM	Flyboys
EQkmdFtC_W8	Convoy
R15FezDA6t8	Fat, Sick and Nearly Dead
_elGFZrJN6w	Nosferatu
Phy3rh9NHEQ	Animal Factory
lq49P3C2fmQ	The Fast and the Furious
rmw2oqiW4Jw	The Miracle of Marcelino (Drama
fwMSIZADCik	Murderball [Broadcast Edit]
07p8w1N58j0	Jamaica Inn
Ku0kogNCh4s	Across the Tracks
O4ZtTX5EmIA	Living In Oblivion [Broadcast Edit]
-i6SjbE0SEA	Manos: The Hands of Fate
1o9SskdQWzw	The Bishop's Wife
jgvEvgYXa4o	Glen or Glenda
tQ9HYSeKzyg	The Lady Vanishes
DhJVMbsfOTc	The 39 Steps
ZzKs_1rwiNU	The Greatest Story Ever Told
6UJ7WOamJrM	My Best Friend Is a Vampire
1VyMTx7DE2Q	The Naked Kiss
bv11KU4Ifqs	Fiddler On The Roof
t8-gxjy7zIM	They Made Me A Criminal
kiZNiQ3TZdc	Zorro
EASiqCNk8o0	Santa Fe Trail
X5vFHGYSzUs	Sliding Doors
J6VLiKyL5MM	Vertical Limit
fLoectapepk	Les Mis√©rables
RMoC_9kyVzo	Flags of our Fathers
s2mj6YSzfFE	Black Hawk Down (Extended Edition)
J1VNz1NwUaQ	Ernest Saves Christmas
I-e9dPnFL34	Lady of Burlesque
5cJ8_GGts1Y	Under Capricorn
ZXVLozNYJAc	The Brother from Another Planet
AYn4K5dNjW0	Only The Valiant
9aJ5j8HH46w	Sabotage
10MFVT7p_3Q	Film-Noir
pJTmThcDOcg	Mississippi Burning
gvAyykRvPBo	20 Days in Mariupol (full documentary)
d13ZaqFRP-0	The Hero
kLtFi1TpQ5Y	Frank Borzage's Iconic Film Noir I Moonrise
-B1ZJjUFhBg	Snapshots
5hMpTuDsNmg	RiffTrax Live: MANOS: The Hands Of Fate
rSBfSUxGy3Y	Lost Horizon
mfcAs0eBhrw	Lord Jim
rW3u_LTd0Uo	Mortal Thoughts
vxjyVFW2ifI	It Happened One Night
AXMjAzSXzpA	Suspect
hHpXK56rsJ8	Sahara
6vo7Xp_NcBU	Born Free
AF5M0FC30L8	Fail Safe
pcBhZbOCruI	One-Eyed Jacks
1xQucUIFA5c	Thomasine And Bushrod
6i0cO_hmRDw	Pal Joey
gVZEEaxMJKM	The Deep
iEAF9v8bLvg	Holiday
kRPx8RFpp1s	White Tiger
JFQcOvXvJ5A	Quicksilver
p6UfWzQ2N1w	Desperate Measures
hhdzshYjYk4	Punchline
Tz3MeVccdXA	The Taming Of The Shrew
X6alGcvBK8w	Cactus Flower
BKW0J6etVSA	The Trouble With Angels
dEl-x-SzAvU	No Way Out
FsmQPYmVzkc	Murphy's Romance
PQVnZw0JGDw	Dead Reckoning
ckxYZ93bFVo	Switching Channels
v7ZMZ94wlWk	Fast Forward
eTvH9LnfBeQ	California Suite
d3b7lfbCN0U	Spacehunter: Adventures In The Forbidden Zone
Clfnw8cfYbQ	The Razor's Edge
el1hBeIEjWk	Arrowsmith
VksNZi5mWfc	South Pacific
sUj0X1Xl4aQ	Ginger Rogers in Classic Hollywood Drama
qq4requMqvY	Jason And The Argonauts
5GMwuV9MtXQ	Anzio
kvnfrjw2asA	White Water Summer
ExaMZmVyi8M	The Odessa File
8etkpPUlQ2s	Jo Jo Dancer, Your Life Is Calling
TG2CUfT1Rsg	The Round Up
bx3bioDXOuE	Even Angels Eat Beans
e8upkhkI9D0	Lady In White
cg2d8QgIrkQ	Hell's House
VSlvO4SP5uA	Bingo
5c7N4azcC2c	Mr. Jones
0wYmV4ZcJgQ	American Hardcore
56P7tKmZjUo	13 Ghosts
o9gCPi4ilEk	Agnes Of God
CyRfJmac9a0	An Engineer's Tale: Werner Herzog's The White Diamond
cjQqFqV3ndM	Great Expectations
6mVj1XcoGO4	West Of Memphis
Iz_mL70wOY0	Family Business
EDTYkDqx7nA	Hero
cQ0YiIyTdjY	Nicholas and Alexandra
3X9KiUJbP8U	Gloria
gMf72nW02eU	Gilda
VQspp5T2-Nk	Lost Horizon
bcwZhH0itrk	Ship Of Fools
a533rh_-p8Y	The Long Riders
B2VgjEtEYzk	Academy Award Winning Western I Barbary Coast
qXAwQAW7t54	The Devil And Daniel Johnston
VIifQ1bW5SQ	Gloria
3N5nR5-5DtA	Gidget
NbEpcGDwFI0	King Rat
MgVQGug8NvE	Blind Fury
GdWKsxasXzE	A SONG IS BORN
WgshvrleGvo	Sinbad And The Eye Of The Tiger
C3PaNrmMDM4	The 7th Voyage Of Sinbad
S3RrlwMfA_A	Nothing In Common
Lzi1VCSeklU	Blue Thunder
hiGB8Ywjv14	Cover Girl
gm3n3cCmrFk	Solo
ftbrOjDrvN4	Riding Giants
YHdMOFCnuys	Gardens Of Stone
GEVsv8unxDs	Jury Duty
eaJQaJOsH1k	Orlando
v8r6-2UrFEQ	The Scarlet Letter
wOcFc7CnBeg	The Beast
9P8Jw_bEdS0	Carnage
mnZMscRFOBs	The Golden Voyage Of Sinbad
bjPAuD5HLiU	Sea Devils
Zu_saTZFuBI	Limbo
wZ3iUK_XNNE	Cops And Robbersons
eVWk5DgNUxk	Perfect
BCU7U5y6Yh0	Paprika
OITrTnAqWI8	The Big Combo
WcTqF5WrNnc	Blood On The Sun
A94Jes2rhd0	Lost In Yonkers
R3SLX25fTss	Crossroads
g3nNRUkVmC4	84 Charing Cross Road
Y_He5JF0dp8	True Believer
FEgoLeloXLY	Cul-De-Sac
zpKMxRydxVw	Squirm
p9t8KK3EXYk	Tap
WVimoL2oGeU	Oklahoma
m5vASPzHNY4	In A Lonely Place
38S5uzznWAk	Roman Polanski: Wanted And Desired
Lo-Ks6_LlaY	Blind Husbands
LJ3CjiDHcDs	Man in the Attic
Iu8eQlzSfcc	The Brave One
EjhGS7WqKrY	Party Girl
bJ_oa0ctn_M	Only in Theaters
uP1I5AhoUQo	Classic 20th Century Fox Romantic Drama I Seventh Heaven
VE1O9SwwB1c	Bringing Up Baby
0VpTDvUCi6s	Creating Woodstock
Dt9MIvaltKU	Franco Nero in Classic Lucio Fulci's Western
83qxuN3srpk	The Unknown Girl
QVnNvcYNLbk	Queen of the Desert
g1DAAfBSqCY	Days of Thrills and Laughter
AK2u-qWboEs	The Night Before
WUWCQ8S6D3k	Betting on Zero
iwrLGSVuVyY	The Omega Code
5x99CEkYuaE	Terence Hill & Bud Spencer
M_qf7XHjvBk	House on Haunted Hill (Restored)
l-FGlw6jWgQ	Night of the Living Dead
DvYB6PjIvyk	Mother Lode
jyYStPzfT-8	Martin
FWNw7u_ndSY	Fright
v6kkI17qA0g	Things To Come
tuuzELtV3Ks	Fear In The Night
EJXtZWrH0mU	Certain Women
dI78uC_JbBs	The Fourth Victim
jjhGLqkU5bI	Going Attractions: The Definitive Story of the Movie Palace
NBOGY6GPg6s	Classic Psychological Horror I The Spiral Staircase
58Id__gyyA8	Flower
gEwb3eLwl04	Crime Busters
-c9RETPodfk	Zorro is Back
ImHnYI2a_fg	TEPEPA
a5MKhznoRBY	Gary Cooper in Classic Paramount Pictures Movie I The Cowboy and the Lady
uW8yg-04mcA	Two Days, One Night
TPSzGgtOxBc	Finding Vivian Maier
xcntZx9Bo00	Uninvited
7MLpEv9Bztg	Banana Joe
ONkGcI0pODU	The Ape Man
Fcx0yQTI7ZY	Big Eyes
tJv3GVKscVs	Far from the Madding Crowd
jLSBmNrg81w	Kiss Me Kate
9dMCYL5tnFw	Captain Horatio Hornblower
1nNiUBVwF-o	2010: The Year We Make Contact
Vx2IU53lmbk	The brothers Karamazov, Part One
sLCfCqQ1PNE	Following
zExVVYzeQlQ	How to Survive a Plague
RRP6L7qfXSs	The Way Back
ZonJGiwIrVs	Frances Ha
1Axnm-ZxWzk	Spirit of the Marathon
V9Fh3jqMZTk	Super Fuzz
XAv5L9uEZpQ	The Sci-Fi Boys
e19JpplvzOA	The Accountant of Auschwitz
KAKtZKeU_qk	Scrooge
9aJquYlLrGI	Antony & Cleopatra
WOmQCENtuKk	Certified Copy
aTCgNVL18l4	Pina
qkHqDfK644Y	The Trip
L_sCvrAf3BQ	The Kid With A Bike
Wcxm_e1n_sQ	Big Bad Mama
rMd9o2vqyYE	Scrooge
d42lSci6VHg	Magic
AzLCsFIdWoA	The Boys From Brazil
MbmT7d_-d-Q	A Walk In The Sun: The Definitive Restoration
NxYU7ZtCn9U	Card Subject to Change: Extended Edition
L4unvareZL8	Double Trouble
LZnCfn4W-8s	Donnie Darko (Theatrical Cut)
5Q2UVbGi3Rw	CUSTER OF THE WEST
ceVhg-2vPwg	W.
P2OuZOZ8vPo	No Retreat, No Surrender
LN6bPy5JDhI	White Zombie
lYyKmiB1M5E	Heat
6v8e7dUwq_Q	The Corporation 
Pj-JPBHkMeM	Hollywood Ending
zIZXGXE1aF8	Evel Knievel
X-4LQzazwUs	Welcome, or no trespassing
q67QIC0qMV0	The Long Walk Home
fmaEVqpqu10	Wanted Dead or Alive
Xz7xNt4Gtmw	The Stuff
y7ob0nbe_CY	Transylvania 6-5000
oIhvkKsrlp8	Memento
rBiNn3f63o8	Maddalena... zero in condotta
wtbznAiEcTo	Go for It
4Et-0iQuyXc	The Bigamist
a-LVzKFWKM0	EMBRYO
5CrfPBjHgl8	Get Shorty
E2Bx0XRcCno	The Westerner
AaEcTLSbSMc	Abraxas, Guardian Of The Universe
gMVponWjcpE	Stroker Ace
vCIeG9vGsew	I Know That Voice
egf0DF3R7Rw	Prince Valiant
6-Vn_As1IG8	[4K] ÎΩï(1985) / Mulberry (Ppong)
qPScCOavuY8	Letter never sent
RMggxX5xj2o	The Great Escape
yFrQkRdAAe8	Crimewave
vAEI3arNVBc	Everyone Says I Love You
SMYknkIn60E	Pot o' Gold
ZXGsbowkY3c	The Devil and Father Amorth
TDnS4d0j-Xc	Timecop
7oXtTHTVAs8	Point Break
aSoGjprY070	Martin Luther
dMqF9MBCcGc	Silent Night, Bloody Night
3sQM2FXuIPU	The Horse's Mouth
PIJICzhe0T4	Harmontown
9k4DqkcFlI4	The Colossus of Rhodes
ELo50ZkA1RQ	Hands of Steel
ZhujB3AZ4kw	Four Weddings And A Funeral
gc-_BRdIX1c	Roustabout
05ReFYqxIsk	Over The Top
DcbX7-imp8Q	The Last Laugh
OP2lW3QwsMA	The Private Life of Henry VIII
XZHrPiaXJ2g	Apache Rifles
uuWbEIazrBk	John Payne's Classic Western I Silver Lode
kUFw-Jk8jV4	Still Breathing
oswp1Xoo5g0	K-19: The Widowmaker
BvD8ww5z8sE	Tales Of Halloween
-sAvT9bf4pE	In Which We Serve
6myjV_cVGMU	The Agronomist
Csnx6likOPg	American Animals
YJBegWk9ji8	Roman Scandals
qlNRL4GOyiI	Hitchcock
ZhiOEPFv3is	Devil Dog: The Hound of Hell
16iJpRtg1gA	Hot Enough For June
X7PfWzytahA	Sapphire
cO95DRG44x8	King Solomon's Mines
9RJy3ohid9A	Madeleine
KkmxmBy6_oU	Bad Moon [Broadcast Edit]
osGRzPkk9bQ	Tarka The Otter
x0Zxf-EcHMY	A Town Like Alice
P6sinDlvfGE	Man Of Aran
t0mPD75bpNc	Silent Night, Deadly Night: Part 2 [Broadcast Edit]
lZzRkHZptyQ	All Night Long
Gd5vuMUBkNU	Millions Like Us
fw1_n_B7LMA	A Song is Born
s498oWofr48	Ball of Fire
FPAXPiuJVjg	Samurai Cop
wZ_oitIKfXo	Odds and Evens
P3HTvXIXhUA	The Gold Rush
Q3b-q9W0AJw	An Honest Liar
8BaaMXAxpnY	I vinti
KaBDHMQEbKM	Atlas Shrugged Part III: Who is John Galt?
P95HofrWVxA	Carry On Up The Khyber
e6xVuIY1hZw	Caesar And Cleopatra
_0yW94uKBR8	The Slumber Party Massacre
uWTBocoWiAQ	This Sporting Life [Broadcast Edit]
ApNclpl_Rb4	The Ghoul
rh7ztuH_qK4	The Passionate Friends
Ugkkb_2MIMU	Young And Innocent
oUhQmMCa0_o	The Shout [Broadcast Edit]
gW5ZGgl-6U8	The Ghoul
uoH0k0MNCC4	Fast Company
X2XJKF4jJXI	A Canterbury Tale
QZ2s-GJYaCM	This Happy Breed
JIU1Ty_cSKU	Odd Man Out
9GePlsyl0yU	The Importance Of Being Earnest
4-Q7BOkKxgg	Great Expectations
0aiwsHxDkvc	God's Angry Man
IFcvs5YzRqo	Judgment At Nuremberg
G5bqfzGU3nE	Step Into Liquid
0GjJyCycIes	Silent Fall
eu0MxIWwIjc	Steamboat Bill, Jr.
qsWZU8GPS4w	The Restless Ones
FiwcqyB7nmA	Ninja In The Dragon's Den ('82)
Uudjg5pAebo	St. Martin's Lane
JPdHVHieomw	Dark Star: H. R. Giger's World
fR3gujz-PiM	The Chase (1946, Film-Noir) Robert Cummings, Mich√®le Morgan, Steve Cochran
xHBKJ2_4Wu0	Carrie
qdP0OVlHOOM	Necromancy
7jbYed_DkD4	Silenced Voices: The Hollywood 10, and the Battle of Free Expression
eUkE_v8l4K4	Hitchcock
b4gWDgD0Fwk	Galaxina
Sh7IR7nXVP4	Twilight Zone: The Movie
LXeYM1zTpuY	Local Hero
GjD_9FrokEI	Nothing but Trouble
-Hw9qbMgCEk	Palmetto
zMFf4iqterc	The Glass Bottom Boat
AtUQeFMHT5U	Revolution
b-IMJP3c8z4	Home Fries
yqrUVBgeKWo	Uptown Saturday Night
ZNzFKMQiy7o	The Spitfire Grill
0P3UBwvyrDY	Corvette Summer
8H4Ut89au6U	Stealing Home
wonz5n620Ow	A Fistful Of Dynamite
BShmGrYMl2c	Winners And Sinners [English-Language Version]
LZIE-NvFQro	A Cry In the Dark
fk38r14LxWM	Jamaica Inn
sl222t-VL68	Death Ride To Osaka
d-dw5mmR-f0	Sweet and Lowdown
1m7N8c3PHOM	Tonight Or Never
2wnndv1_z1o	Conduct Unbecoming
fUGMgxOVzbw	Song of Freedom
fShaskBS_yA	Tennessee Williams: The Roman Spring Of Mrs. Stone
B0rY25U-zMU	Becky Sharp
1rAvFXto6Ws	Knife of Ice
guIXz0ToGwA	The Last Days of Patton
Uvv_4wQVihU	My Favorite Brunette
jjm_b-fSQS8	Sleepaway Camp [Broadcast Edit]
GiRpVyeiTSE	The Red Shoes
lIn7THCMxBc	Sabotage
HoWe8DlGBgM	Black Narcissus
EjPhyqFPIuw	Timecop
9KHSAT0uEes	The Exorcist III [Broadcast Edit]
KOtMk0t1fo4	The Imposter [Broadcast Edit]
xoqY0sVwKzA	Piranha
h3RyouSN1YE	The Life And Death Of Colonel Blimp
J4q19yWK004	Day Of The Dead [Broadcast Edit]
FAeiohXzLl4	Oliver Twist
B4h3M7RlShM	The Lady Vanishes
84Bg13SsILY	Nightbreed: Director's Cut [Broadcast Edit]
ElntXB6dpcc	Film-Noir
xYvk9WEsNY0	The Secret Of N.I.M.H.
ELYXpTNid8A	Philomena
xD92Kwj4x0A	Distant Harmony: Pavarotti in China (30th Anniversary Edition)
naV9hrF5sIo	Nothing But a Man
76aSjLj_Qqc	Alice in Wonderland
vX9cmU1p0K4	Borgman
ZtDOVL2gdK4	That Uncertain Feeling
F9QY8avcQ98	The Snows of Kilimanjaro
xi4ijRWH5Hs	The Panama Papers
auzcKVvqpYM	Nightmare Castle /Amanti d'oltretomba
uoTJoLZbd1w	Outfoxed: Rupert Murdoch's War on Journalism
J8DGjUv-Vjc	MINIMALISM: Official Netflix Documentary (Entire Film)
8xmX6iX2ZF8	Go For Broke
BTKNkPMbd3M	My Darling Vivian
9C_jWktlLCc	Hara-Kiri: Death of a Samurai
a9TS8iXxyVI	The Fiction Makers
fDVBpeLDNm8	Bad Timing: A Sensual Obsession
TvSYwIJGBK8	Lisa And The Devil
TaExCEP38YU	Brief Encounter
lAtIh1E28GU	Love, Antosha
e9whfTmNYuU	Echoes From A Somber Empire
VyVBe-NF3fE	Black Sunday
EcXRi5CK7rg	The Evil Eye
3OteBWigCOM	Huie's Sermon
yk8xcdYLQVY	49th Parallel
m3OxmddjMaY	Herdsmen Of The Sun
ZFGVz-eNrhg	Hamlet
XIQR2-iLMkU	A Night To Remember
O36adDm7Abw	Henry V
7-ZADmE9zfo	Blithe Spirit
4WeZP2NJYOA	I Know Where I'm Going!
4N1cNVL9pQQ	Baron Blood
tUA7a21pQg8	Born to Win
LM8hR0lpw4s	Kill, Baby... Kill! [English-Language Version]
csbcfZIRCnQ	Adam Driver ‚Äì New Movie
nuyOpmK2zVQ	Steinbeck
425yT-mqbkw	A Star Is Born
RxnXaaAUx3A	Spider Baby
NFNKjAS6tT0	My Favorite Brunette
3PVDpp1v2dw	Road to Bali (1952, Adventure) Bing Crosby, Bob Hope, Dorothy Lamour
ClJ2OdNdtHg	Fight for your Life
v8DkXR-B3E0	Legionnaire [Broadcast Edit]
YzSMFWKCHhg	Downfall
zbCWyL0n6pY	One Day In September
s5ti6bJfHOo	Who Killed Teddy Bear
CA_EK8kp51w	Truck Turner
2AMLUNcdrnU	The Video Dead
qkefNs1W24g	Evilspeak
Rnsq68qsAuA	Tonight or Never
1YvLtQ3p-Pk	The Torture Chamber of Dr. Sadism 
FZWlWeg26s8	Terror in the Family
Be-2R2AE1DU	God Grew Tired Of Us
HqcEV998tQ4	Creation
z98pd3syyeE	Whoopee!
hH_PZgs-3Z8	The Adventures of Marco Polo
0tyBDRYy7Ho	Arrowsmith
wnP0N02HOhc	The Phantom Planet
0ZSxH_WBXU0	Black Sabbath
TmmJSDncZ9s	The End
elV3FQkGxg0	Taras Bulba
xLXmQUWWi8g	Tentacles
-ebGcS_yeBM	La Cage Aux Folles
hHOAezWjFxM	Love Field
-_252aWcfqU	Stormy Monday
3d200wKZscM	No Such Thing
zdhUDxDOiMY	The Heavenly Kid
ShiKAsHSZxY	A Kiss Before Dying
bPG72oEaRZw	The Wild One
GMTItzWIiX0	Buck And The Preacher
GjFFN4OiwqU	Youth in Revolt
g_jn4JP1yqc	Moll Flanders
aYb65vZQUNE	Dead Of Winter
P9jvE2SXZlM	Panic In Year Zero!
xHAUbx7NEMU	The Trip
hx8x2ouhCpE	Noon Wine (TV-1966) SAM PECKINPAH
CiTVjL4Ivys	The Broken Circle Breakdown
gDt2qK_ZNQk	Alfred Hitchcock
zHA5jp3XvGw	The Sadist
A5honBW2css	Raiders!: The Story of the Greatest Fan Film Ever Made
7ylPMkK0gUo	The Outlaw
lWyGQFNi-Gg	Firepower
40-wgrFMNcg	Small Time Crooks
edak1Gbcvg8	The Dark Glow Of The Mountains
Uqi1MdeTt-s	What We Started
RJasKZlaIcA	Movie Movie
Om_cNOUl3FE	Crazy Mama
4S40he-wuN8	I Am Big Bird
bIac4d-CKvU	Pit Stop
SUa1xDXymLY	The Saga Of The Viking Women And Their Voyage To The Waters Of The Great Sea Serpent
NPvyBP2l_hM	The Infidel
Quk1hS2LUsA	War Of The Satellites
LS9YuYVIelo	How Much Wood Would A Woodchuck Chuck?
bI07fxmlLGY	The Wedding Night
zSA6JgcBN7Q	Trapeze
A9suzljYwic	Rewind This!
cL9nE7A2qgE	Death of a Superhero
lsuY5dYxOCs	Stargate
a6ESGI3ri9U	CASTLE OF BLOOD
RGwd0ZKq9_E	Misery Loves Comedy
kDVATU7-yuw	Alfred Hitchcock
cAiYfc8W35Q	The Most Dangerous Game
gFq51lAfQak	The Overnighters
NzVfAj4bV40	Colors
iiELmkrn7pc	Nas: Time is Illmatic
9M-7ET9zkf4	Charlotte Bront√´
VGn0Os90uz8	The Little Princess
LU0llubfGts	Film-Noir
Vv2SuWIw3UA	The Domino Principle
s4huXgvrDIs	Screamers
LGKCIfbe5qE	Moonlighting
H0ZAQ2frWuI	The Man In The Iron Mask
nCY_dmjSA9M	Teenage Caveman
nQX_J_o1xEw	Dr. Jekyll And Sister Hyde
fWKJYl7SblI	Shaolin Wooden Men
SV-hEQWsz1M	Machine Gun Kelly
MvQKPiaDM8E	The Great Ecstasy Of Woodcarver Steiner
vqPyttFGn9A	The Undead
MssUHlG2Yqc	Wheel Of Time
HSQbZwgm_BA	Bergman: A Year in a Life
36ThKkjNX3Y	Listen Up Philip
MShaEVuw_BM	What's Cooking?
DU4jBsJ6TXU	The Brute and the Beast
gBQDdr0UwiQ	Underground
az5G7wQDIzM	Sunday in the Country
ueqgOjHz_Xo	Big Fella
GwaAoP3Izb8	Mutiny
puw0KRFMbSg	LASER MISSION
MtIQr7pLDEM	The Whole Wide World
aP5iOoBlJFQ	Mission of Justice
AbXkyUBU1wE	The Mystery of Natalie Wood
A3CK9Bq6e3c	And God Said to Cain
fWsSxFd3NRc	Prisoners of the Lost Universe
9AgD-Jt1lqw	DESTINATION MOON üé¨ Exclusive Full Sci-Fi Movie Premiere üé¨ English HD
jg72DChjB_4	Shakespeare
d3hG9zyAGhQ	Ants!
NCU2dtlOvtE	Santa Fe Trail
x90KkgpdPpc	Sophie's Choice
sW49uvK6HSc	Game 6
3HKUbQtN0Gk	Boardwalk
EkczfQU767s	RAISE THE RED LANTERN
DA_UrBAv6vk	Moonstruck
2xQUjsBCVZs	A Walk in the Sun/UCLA Restored Edition
85PirbW5ESw	Milius
Hp1avBQu67k	The Little Girl Who Lives Down The Lane
vVTh3NHFwbU	The Party
_3phon3fJrE	Father's Day
YOE0lR__o6Y	Messenger Of Death
VDrGMOMbtbk	The French Lieutenant's Woman
5YmEm8wuzQ4	Made In America
fh29c0icReg	Tonight Or Never
Zba67JwaN2o	FULL MOVIE: The Ratings Game
78G2oSJkhnI	Burt Lancaster in Classic MGM Western I Vengeance Valley
V9sbSV3iH1Q	The Curse of the Jade Scorpion
LxkzHRi8NuE	Some Velvet Morning
u8nRmYj3GTQ	Royal Wedding (1951, Musical) Fred Astaire, Jane Powell
iOhQ6lpVfA0	The Visitor
CRHurXwApLk	Minnesota Clay
XYXhQZAnEjo	Cold War
hoHc7dz--g8	Held Up
iqy54ZBEdA4	The Ambassador
HnYo7ph5vJU	The Comedy
Kxmz1vjCOk4	Don't Go in the House
YDTjp0KLaZQ	The Ruling Class
67BmGjnN8G0	The Wild Blue Yonder
jipp7cAEW64	Raining Stones
Z27RtlaxSFg	The Milky Way
DWgwnsIuDf0	Music
ntgJOXRZyH8	The Monster Club
cwyqnT6n0mk	Communion
bjzzfrXtsIY	Riff-Raff
-A_DYnBft20	Asylum
jvhLwkTNfFk	The Cowboy and the Lady
O2mJEQWtF68	Voyager
txyN-Z9Mcmo	The Kid From Brooklyn
bByANuB33kg	How to Make Money Selling Drugs
DC-fOFXUFoI	Far From Men
5myY1ILoN8E	Africa Screams (Abbott & Costello 
nFuUuwPaSfU	Jeff Bridges
H2kxu-e3MIE	Cecil B. DeMented
pISjbjHfqC8	Angel on my shoulder (Film-Noir
V3SIzeDpCcw	In Old Santa Fe
X1MfrIq590E	HORROR HOTEL (CITY OF THE DEAD)
M0sjBKTUSp8	Ed Wood Jr
poh6A8fDtHI	The Deadly Companions
Pn_9xoNK4gY	Made for Each Other
2Qmu-oVkNl4	BMX Bandits
o7RgwJ9htag	Hobson's Choice
Z5oFHiA4ltA	The Monster
9f08scgpGX8	Great Expectations
lrREmd4ds_w	Herman Melville
KlFUi8UX8Ro	Horror Film
2lhNqd5Nq7I	Comin' At Ya!
YuArYY5F8l0	Our Nixon
pcFcplZOLJE	I vinti
dQSi1GHHcbE	The Object of Beauty
6FZJoAWCb3s	20th Century Fox Classic Family Movie
RmSdum4BMqI	Alfred Hitchcock
csgGEZzhojA	Voyage Of The Rock Aliens
Uozmpw6KnGw	The Magic Sword
RKESE2y4tjk	Love Affair
8RZeyTwdT_4	Royal Wedding
xkdftQ_8-Ls	JACK, THE GIANT KILLER üé¨ Exclusive Full Sci-Fi Movie Premiere üé¨ English HD
Ew5XMjaXTF4	Rise and Rise of Bitcoin, The
oibc_okQWBM	Horror Film
UgEj_uKl-X8	Divorce of Lady X
MiDxhVNPTB4	Boot Hill
eWuWUypxJlA	Last Time I Saw Paris
ROHag1wxBQo	Little Lord Fauntleroy
_8T7U-tTNqo	The Boy Who Could Fly
rIAIi2WalGw	Brainstorm
yyJgJvACsO4	Leprechaun: In the Hood
rI3rKMUfPu4	The Majestic
RptI16hIRts	Follow That Bird
6Sd1npxGbzI	Hearts in Atlantis
6I3_6kpL3lI	The New World
kxri_RBJF5Y	The Sea Wolves
biG2RF03M4Q	Mame
fpTmM80TFgU	Charlotte Gray
DBM1lKrQL4Q	Honeysuckle Rose
mVjMuIHiJcI	Best Friends
hsjETcLrfyI	Joe's Apartment
VpTafaZKwSo	With Honors
RQj23PTy6cQ	Agatha
rcC0cPw9P48	Who's That Girl?
PzRizOp1WdQ	Heat
rEGtUUT71Y8	The Swarm
DuN1P-VYzE4	Singles
W5wwwXL5qzI	Memoirs of an Invisible Man
9HkM3ZSbuDA	Iconic 80's Movie
TkZa_9QjXbQ	20th Century Fox Iconic Western I Broken Arrow
37LJpExHdLQ	July rain
qgroGzD3DI0	Mausoleum
tRvL7E8e5tM	Paperhouse
3EBktAo6LUI	Ice Cream Man
um1Tc-PYhx8	Beneath the 12-Mile Reef
jrrJhEh3qkc	Pauly Shore is Dead
jvVkjTzAvYA	Lee Van Cleef
10Cjx5_AMIA	THE SLAYER
f1YNitdHR0U	The Sky Above, The Mud Below
GKEvPUSaAnE	Man Bait
XsA4bmvRSU0	Angel and the Badman
rG1twlWuQbs	Making Apes
-7p_Ju3C-jI	Summer Storm
0Fe9S53-dDc	Contamination
93lLSVWsD5Y	Stolen Face
S2il7XTq8Es	Sun Ra
_Dl6g1tsLsQ	The Round Up
Cu7bCo2Kbm0	Assault On Precinct 13
2xnPtDrq_B0	Romantic Comedy Movie
HRoacGSwoo0	Deluge
my2TqBWr2hQ	Dangerous Moves
iBW6gOuAUbg	Bad Blonde
iSFrz0_v8NQ	Little Big Horn
MI-CSppIqMk	The Black Orchid
qV33K2-Y2os	The Snows of Kilimanjaro
FyvoEhIQsEw	Genocide
mtkfoDOLiDk	Danny Deckchair
XBFZcy-b5og	Island of Desire
hLRMtJwLWTQ	Police Story Lockdown
rhxrdJLC7lI	Bomb City (TV Edit)
YxlYXUDwZtU	Mistress
tqlJeqJopTQ	House of D
l1vcyOsYPX4	Best F(r)iends: Volume One
6BvbRANF52k	Fitzcarraldo
c3eYElAH_3A	The Town That Dreaded Sundown
Jk8gqJojh-U	Dream a Little Dream
DJ4TQ9q8rPc	Sicko
Z4fQhDox2I8	Facing Ali
HMOb8NCtjFs	It's A Mad, Mad, Mad, Mad World
fpk07HQ3zE0	Cat's Meow
98toFJt2Bds	Endless Love
5yT-c8lO7Vw	Top Dog
ilIKWjOuc5I	Blue Ruin
7TwPxhEHn9U	Mandela And De Klerk
jc3Vrz4OnY4	Life with Father
_UtctfUfreU	Who Am I This Time?
zhgrIIttGWY	A Walk in the Sun
t7V0IZ51wDg	Red Dawn
WV7ToGWO9vk	Appointment With Death
YFpx8whBF1g	Theater Of Blood
BMDtlh0R0HM	The Misfits
WwW44UjYeBc	Burnt Offerings
fP4vQp91M2o	The Private Life of Sherlock Holmes
1t4nkLkQBFY	Thief
nWMN4vp4A80	Mac And Me
WEnv5I8Aq4I	Requiem for the American Dream with Noam Chomsky DOCUMENTARY
7e4Pr3wSH7A	Iconic Jack Nicholson's Classic Western I Ride in the Whirlwind
oYDFhMwn5LQ	The Stool Pigeon
SLoYmCAE-gM	Horror Fantasy Film
a10V_vKZkB4	Jack the Giant Killer REMASTERED
204SlLFd9Ug	Henry Fonda in Period Drama I Young Mr. Lincoln
0ZbFqgfyUrI	Grand Theft Auto
X-U2MYYjuXM	Hang 'Em High
HaPnGWerVuM	Into The Blue
2JD0c-cv0yg	Be Cool
mbK_ywg6Lgc	West Side Story
dcmUVB1UPho	A Summer Story
jcdMjx3KfPc	The Trials Of Darryl Hunt
GH2VI5JzBq4	The Old Man And The Sea
XUx2Ljv2_9Y	TENEBRAE (DARIO ARGENTO) üé¨ Full Exclusive Horror Movie Premiere üé¨ English HD
HU3lcZU89_w	PHENOMENA (DARIO ARGENTO) üé¨ Full Exclusive Horror Movie Premiere üé¨ English HD
xqTvvSYvnVg	Iconic Romance Movie I Love Affair
pCS1nyztMiA	Return of the Street Fighter
3gTxg8AXW2E	DON'T DISTURB THE SLEEPING DEAD
VgSbqGJL3Z8	The Ring
OSA37nb47-0	The Manxman
0gagZmR8ewY	The Farmer's Wife
BwrEJTPEhCc	The Horror Of Party Beach
Llo-wOmAkYs	Django Kill... If You Live, Shoot! (Western
bT-TjuEoM_M	The Lively Story Of America's Greatest Film Critic
Dg6HTFhDS_k	The Big Trees (Western
G5TBk34R92k	When Time Ran Out
-Kxzwpwp0RE	At The Earth's Core
AMnC9sEAfzU	The Astronaut Farmer
vtysBisjDq4	Odds Against Tomorrow
jucRgJ8_6gk	Frankie And Johnny
o0gWpnddq_8	Meteor
-H2n6EyyV1A	The Pit And The Pendulum
xzT7SRyW264	Roger Corman
btT8oSVV_s4	Romance, War Movie
harUjkxPnyg	'Safety Last!'
mAfM_1RirWY	The Best Years of Our Lives
zCdWmnnnWGw	Heartland
_fHnNMCORPc	Silver City
KtdRRWieH_c	Homeboy
5vTXKKgeWpA	Mystify Michael Hutchence
QQGw7wM_pBc	Lord Of The Flies
2TrZVxVrQWA	A Bill of Divorcement
pgauT6mmK4g	Children Shouldn't Play With Dead Things üìΩÔ∏è FREE HORROR MOVIE
xKH7XaxGJbU	Stories From The Strip: The History Of LA's Most Infamous Street 
SZDTWh4Wnow	Native Son
2838WWffOpM	National Lampoon's Senior Trip
jURpEJqA2tM	The Awakening
WtCRA3_HlrU	The Company Of Wolves
wSgo7diXL0s	The Shooting
shAEH9XGAss	A Night In Casablanca
FZ57Gz_AnhQ	The Count Of Monte Cristo
qT3qn15uMeY	Number 17
NYatLKK31-g	Zulu
bDRV2MR98j0	Boogie Man: The Lee Atwater Story FULL DOCUMENTARY MOVIE
DsGB2qqKn9w	The Saga of Anatahan
_VhCHcAFCFk	The Terror
iriDjaFagxU	Men Don't Leave
tx3fTXTKGxw	Another Country
XuRpRmxH7bQ	Liberty Heights
MPzSc3GzQWw	Sour Grapes
g66dsHIeKk8	The Sea Inside
onYLs7Q3Zkk	Oh God! You Devil!
NDC44RpsgaE	Heart Condition
AHD_2TrSQmA	Shopping
QfgF18tb7vw	Big Girls Don't Cry...They Get Even
Htyfj6y0s3M	Stepfather II
rUH7rjzDbE0	Metroland
qzFsCnjRDbo	Simone
rsejSKPgzlo	Guilty by Suspicion
XwNhYP9f2hI	The King of Kings REMASTERED
6RZlpZCzA3U	The Cave of the Yellow Dog
ZWBepNts1V4	You Laugh But It's True
agXNqrSIHpA	Milano Calibro 9 I
SEIDXsPai6M	THE MANSION OF MADNESS
knOd-BhRuCE	THINGS TO COME (H.G. WELLS) üé¨ Exclusive Full Sci-Fi Movie Premiere üé¨ English HD
ryP6EICFmlY	Fair Game
iVJh2cdTtAI	Her Alibi
gkKdEncJkj8	Little Foxes
VTqTpGXlHms	Made in Heaven
YQ5yTnIOgTI	8 Seconds
D3iVXc0wQsE	Critters III
yye_gPnVP20	How to Eat Fried Worms
NB20SDFEleE	Strange Brew
f1AeJvJAOk0	Burglar
Z6l9g3ldlCI	A Scanner Darkly
DC0bt7wJEV0	Vision Quest
Ky2wjGJ3vdY	Suburban Commando
O_ZXEg271js	In the Mouth of Madness
yMX2IRvyDZU	The Astronaut's Wife
UIZzbqc7pQc	Critters
3EAbYjIGNGw	Wuthering Heights
c4Cj4YBVxGw	Osmosis Jones
avqrCxb3FNA	Cannonball Run 2
MozISV_DZNE	Everything is Illuminated
x5ZIyfY14T4	The Salton Sea
RBJqfU_oKtI	Alaska
cxHT2vhHDb4	Rear Window
sQ35umEEBho	The Silent Enemy
mPkBwJiN4-M	Bing Crosby and Ingrid Bergman in Classic Comedy I The Bells of St. Mary's
SRHNfv66Uyo	American Street Kid
fYvpXdSR8gs	Without Limits
-KbWVp5kSpo	Quick Change
QYxtOq7mi54	Prairie Home Companion
laMbgNh3uns	Akira Kurosawa's Dreams
9J-upqUFY0Q	Feds
EsmWygTrKWw	Disorderlies
2RA3q-RKyNI	The Perks of Being a Wallflower
prJlKSqqd40	Man's Best Friend
NfZqKRL0r8U	Nuts
WtwU_WhQO2E	Other People's Money
iOelfhJ08V4	Big Wednesday
QB2LWS6_w4c	Love Affair
kW9i37NdZ7M	For Your Consideration
ZFyOtuB1HzI	Critters 2
_U6omAv2Mds	Moving
qlzBH09FZnY	Wolf Creek
5d7hJzSbEqk	THE CURSE
ooez5dAnddo	Nothing Sacred
TgGvFPB8_yI	Three Came Home
4pC3PMH_-hs	April in Paris
ILZ7MpWo9wE	Road Games
8OYvuKBnXc0	Diary Of A Hitman
i--mEfdgXpg	Galaxina
ya0EutKBh2w	Manufacturing Consent Noam Chomsky and the Media   Feature Film
FPgj_TraAAM	Holy Motors
kDjQovjSiAM	Rear Window
yMP235db1i0	Back in Time (1080p)
XaJy4GMQrJE	Plastic Galaxy
KxRpAvJ1-Os	Cary Grant's Classic Movie I People will talk
x0V2GLAQ61Y	Lassie: The Painted Hills
q_irySRhTAE	Who Is Banksy?
USSRE6d6qcA	The Forty-First
5nFQDQMJARs	The Corporation
XfO1A_TOeTY	Go for It
gewXbR3Ryic	Who Framed Roger Rabbit
VDpj6DV-3Jw	Funny Girl
Pf0JW-cAFTs	The Professional
P0xnFA86_uU	The Boy in the Striped Pajamas
frcBYWET0u4	The Neverending Story II: The Next Chapter
86z_rNBtmVM	Three Ages
ZJV0Kx7oGxU	Living in the Future's Past
5-sxjUPVI4Q	The Brute and the Beast
aNIHjvXIk-w	Classic Animation Adventure Movie I The Adventures of Mark Twain
264BO4SKXn4	The POINT
uFofaM6yE1g	Nothing Sacred
DuRX7I40vq4	Gary Cooper's Classic Romantic Movie
55sC5s6yebo	The Doll Squad
xpOkIWH3C2E	In the Mirror of Maya Deren
ZF0bqXW1JK4	Losin' It
wR1Kqor_zKM	In Search of the Last Action Heroes (1080p)
_IBEWC2wbzk	Sharknado
ilG_ghmj0so	Penny Serenade
4NTVe43SIhA	What's Cooking?
guPG2DlhBdI	Chariots Of The Gods
1qz1jHjJOZw	The Children's Hour
bwzjqLSCzRU	FX
O85wA80-lCc	Das Boot
XBKjrh2ZzFw	Runaway Train
uSenjtxbM8o	Man of La Mancha
FsfghDZMUyk	David Holzman's Diary
xz4c__4SZMY	The Golem
CNUvsIdms64	Rosencrantz and Guildenstern Are Dead
k5hbaI2k8jg	Elvira: Mistress of the Dark
bpaC44Xt-HI	Children of the Corn
kVHFcQlOiM0	Kill or Be Killed
5CVbDRlQdHQ	Merrily We Live
da0qTIVCu6E	Russian Ark
iuj8mu2Y0L0	Felicia's Journey
7N9Pm4SuzX4	Certifiably Jonathan
O7ouJAoFXQo	American Teacher: A Powerful Documentary On Education And Politics
_XUjKwidVoY	Tales of Halloween
UDyTO9JHML4	Toni Morrison: The Pieces I Am
JD_U_4NGkdU	Avalanche
E8b84OGx3kc	Free Angela and All Political Prisoners
8iVzHXibwzI	The Search for One-Eye Jimmy
XG5i29zc_QE	Raising Victor Vargas
LfNKS1DydfE	Secret Sunshine
siKw_AjURSM	Edge of the Axe
DyRkReEV3ck	Terrifier
xyzNzLeofBQ	The Lawnmower Man (Director's Cut)
Rl35E90Ksn0	Love And Bullets
FS-bZiCqzoA	Alice In Wonderland
EQEnD2cpBxY	Sioux City
goalPsow7cw	Is the Man Who Is Tall Happy?
yWuSU5YQbcY	Murder On A Sunday Morning
Gq0iSxQsw80	Madhouse
CnaJaRY_3KE	Making Waves: The Art of Cinematic Sound (1080p) FULL DOCUMENTARY
-OwDRftSEno	NEMESIS
5L7E4Y9x0N4	My Man Godfrey
PunoypXDEGg	Heidi Fleiss: The Story Of A Hollywood Madam
WDwBRKXUtxQ	Parents
jGt79HUVBoU	Inherit the Wind
I2mg9Ij1cRU	The Last Waltz
MTRPx4C4hfY	Serving Sara
sKyk8_t1DUw	The Comedy Of Terrors
wcIiYFqW4MI	The Russians Are Coming, The Russians Are Coming
CugtQaWd2fI	Close Encounters Of The Third Kind (Director's Cut)
JcvX3ENewSo	His Girl Friday
Bfchpqex3pE	Tapped (1080p) FULL DOCUMENTARY
BvFu7Z5cc88	Nuclear Disaster Movie I Threads
dMDk5LgfCAY	Child Migrants Journey To The United States
xv5KE_klSww	Genius Within: The Inner Life of Glenn Gould
4Y3hUMuaTvk	Children of the Stars
cfjFAM_BLgc	StarCrash
Qt_ah0q8jFg	Sonny
FJg5jMN5qN4	The Trip To Bountiful
gkUjUsexJw4	Crazy Wisdom: The Life and Times of Ch√∂gyam Trungpa Rinpoche
2fow2KX_VVg	Ballets Russes
9-7leNHaJ8g	Our Daily Bread
Vsnius8Ka_I	Ballad of a soldier
wjj5uNlaZGE	My Best Fiend
_4J9WxsNlYA	The Man From Elysian Fields
toG93T4JzDM	Poolhall Junkies
JPrexubQOJg	Dark Star
VtcaL63nnUc	Way Down East
FsN_8OqCzj4	Blank City
EM7Eoe98FF0	Blue Collar Comedy Tour: The Movie
6xg3TwFQkT0	Nollywood Babylon
9nRnDbGEBrE	Lina Wertm√ºller: Behind The White Glasses
AT7VBmd4J6w	Andy Goldsworthy Natural Sculptures With Ice, Stone & more
E9kLZYyIJfQ	All Things Must Pass (1080p) FULL DOCUMENTARY
ic2EBAw3sHs	Highway Patrolman
yg190J8PaBc	Battle Creek Brawl
WKEQmvapfK0	Glengarry Glen Ross
dZH6KWT5OIM	Elvira's Haunted Hills
pw2meh9nDac	A Walk to Remember
WQsk6DWYvAw	Cult Movie Night
L67g7oHXmeY	The Three Stooges Meet Hercules
0T_dJF3dv6s	Manon 70
kZc8B3IMzHg	Mission Control (1080p) FULL DOCUMENTARY
LAFTHB8OYRI	Speed 2: Cruise Control
1UgpmXHaoPk	Best in Show
HqtSOoySgKc	Winnebago Man
ewVlzvCwiDE	Kumar√©
Sp3v0xOLPXw	Omar
nN8HJB1kI3o	The Parking Lot Movie (480p)
Yo2zmh6VpKI	Young and Innocent
Yh1dOmQJoWQ	The Rise and Rise of Bitcoin (1080p) FULL DOCUMENTARY
tsILzNjvYn0	Trekkies: 25th Anniversary Edition
bHR8V9PgCmY	Wes Craven's Cult Horror I Chiller
w-hmuUAmFHQ	Blue
v6x8R1kbhr8	The Outlaw
9hjvuCwrHvk	The Young in Heart
Gq4ph-bFF7k	Sioux City
U_ydbrmWMOw	The Story of a Sex Surrogate: A Sensitive Look at Sex Surrogates
ePW41_uNbZI	LIFE
MUcLhFdu9kE	Lawnmower Man 2: Beyond Cyberspace
wNpKZwp7Qlc	Reign Of Terror
3tfJMOHwrdo	Classic Fantasy Movie
ncNbhGubUF0	The Italian Connection
Q7MkSpJk5tM	The Red Pill
FI6klfnQkIY	The Haunting Tale of the Friedmans, Child Molestation and Arrests (TW)
1vdCmmXgH68	SAVAGE STREETS ft. LINDA BLAIR
bLRcs4SWCcg	Being Evel
ZMaMX8SBDIo	Classic Period Drama
6c_PobRXZq8	Maddalena... Zero For Conduct
8_s9ubjoBM4	BLOOD RAGE
jaS9N2chm5w	White Squall
-pFAWUCkVFk	Death to Smoochy
ow1jE09IV3c	The War of the Worlds
f-P4MurSK2U	Dracula 3D
Nu9jXTCXA9E	THE INITIATION
PjI4gKERlZo	Distant Voices, Still Lives
oQVL-yKLw1Y	The Devil's Arithmetic
-pEvib3iJWw	SHARK! ft. Burt Reynolds
cvLhzQKfSMU	Head Games
hlpySOQ2AsE	Food Choices
1xAIqDMW8dE	Anti-War Animation Film I When the Wind Blows
5UyRkzQ5N_M	The Hired Hand
9pODV8I01AA	Dying Laughing (1080p)
BL5ZKQ8NZLY	Quartet
YtovwehZlI0	Tourist Trap
0hvnkL6LO-0	Rob-B-Hood
tH-Y3WiwUXQ	All Things Must Pass (1080p)
J8yr5KV9MwI	BERMUDA TRIANGLE
3idxqCSXdIM	Joni
ulmkg41tlcs	Beach Party
NN6bl9IqwAQ	Killer's Kiss
lAoHN4xC_7c	I Am David
BOfHoOwWsfQ	Louisiana Story
ISTnhq4UX1g	Life Itself
UmTfD2OlalE	Nico
0ZmeJIEVuO8	Cannibal Women in the Avocado Jungle of Death
iyWK0v7ks0U	Trancers
m8JMFPFcFDg	Control Room
vtgHclsvSW0	Lost in London
qaKDw_Xbq_g	The Golden Coach
GGo0n7wEHQM	Salt of the Earth
Y7rQxbrF_tw	Half Nelson
Ii9UZhmk8D4	Fever Pitch
4PgpVpto-7A	Freejack
F4SNJ6-tNjo	New York, I Love You
bIij-KQ0jYU	War and Peace, Part One
Wjj0Hgn6mz4	Films of Fury  The Kung Fu Movie Movie
NocpzziSq8M	A Hero Ain't Nothin' But a Sandwich
chPcECU3M2s	The Masque Of The Red Death
ZCwcX1gHupk	My Friend Dahmer
Tqe0zkPkP0U	Teenage Ryan Reynolds! SABRINA The Teenage Witch
8MMVGTD5yjU	Gracie's Choice
Gq4PaJfod4w	Alexander Nevsky
ZjjBdRqguIE	Scorpio
mefDtBXEG-4	Die Hard
MycT5SH3iBE	Our Nixon
bpf9T_jq6Zc	Blood Infused Thriller Movie
vnNgoS8VsoQ	lvan the Terrible, Part Two
ZYOxxp_EVxc	Ivan the Terrible, Part One
1fLB0FJt7kI	Testimony
Kd9cY1rjZKs	Armstrong
MWJnskTn7xg	Classic Romantic Movie
gsg2rSz26FY	The Driller Killer
sFaL03SKEzE	Dersu Uzala
rZ-UCKMDK5A	The Real Blonde
AWvx7jsYWAQ	An Eye for An Eye
5LGibBYuj5U	Sour Grapes
73bn6XXvCLI	The Quiet One
0VnDgCvVmKM	Day of the Outlaw
DdDSpXud0Dg	Man of the Year
0Mk6jq22_Wc	Song To Song
SoR5KjmlTLE	Death on the Nile
Eltx_XIa1kA	Last Days In The Desert
kbp0rnEWGWQ	Knight Of Cups
8ZAYiU9j23s	Dominion: Prequel to the Exorcist
pQikv6sWihw	Just Getting Started
fSXD8aq7c04	Season Of The Witch
wNayuD9KcFQ	99 Homes
f-G3JkCvsUE	Rage at Dawn
a_bkBbrdyyw	Battleship "Potemkin"
i5BCNXhj8qo	Crips And Bloods: Made In America
1DaB_D_NriQ	Roald Dahl's Esio Trot
XY6t7G-LQac	The Ape
Vq3TboX3n0A	The Pope Of Greenwich Village
6ROvPFaUl80	Charade
zjIiApN6cfg	Come and See
ylvhpSlr1tY	The Life Of A Cultural Icon: The James Dean Story (Full Documentary)
5O4eaxJJ-Pc	Dracula: Dead and Loving It
HqIwRyBv9wo	The Hospital
G0xDHzQ3n4U	The Stolen Children
b4IvJjEM8m0	Full Movie: The Forbidden Empire
8DZRaVt50Ps	Bella
xQtw9XBONX4	Black Mountain Side
4YmQn6q36HQ	VIY
U9ob-BZnhBQ	Hitman Hart: Wrestling with Shadows (WWE Legend Documentary)
Q6aYffSSaas	Ju Dou
MTxqA_fvIS4	Charlotte Bront√´ Period Drama
pocltMh4nBU	RBG
d0BjEZUbwmo	Abraham Lincoln
VnSCBNmLuAA	Blackfish
GsuADtnAULU	The Dogs Of War
je75FDjcUP4	Andrei Rublev
gdGGUTzz1wI	THERE'S ALWAYS VANILLA by GEORGE ROMERO
SlDJ2aE7iGs	Strings Across Cultures: Isaac Stern's Journey Through China
y9_ixTXg8CI	Lovecraft: Fear of the Unknown
lj16MvB9YyE	The Secret
V42KtSeo3uI	The Coming War on China? (Military Power Documentary) [4k]
Goe4a6zM9H0	Down to Earth
QIQNVH_ZUHs	Black Jack
f_l1aqwX3KQ	Magic Trip
lBx2g9iNbEc	Alive Inside: A Story Of Music And Memory (Full Documentary)
OwdmPURe8RM	Buster Keaton
N2GWuNTwTZM	Train to Busan
AhRrcAkLR6U	When Fans Turn To Stalkers
oSfyhEbSbh8	He Was A Quiet Man
qqUwNkr-B3k	Style Wars: The Birth of Hip Hop
QhXvppT726Y	Jared Leto
NrMINC5xjMs	The Mirror
V3qOIKrPxYU	The Dissident
rh14eYq91iE	TENTACLES
yzNxLzFfR5w	Winter on Fire: Ukraine's Fight for Freedom
6Lnb1bI0VIk	Ivan's Childhood
mbdFXYzR6jo	CBGB
HyIhqT5bkEM	LIQUID SKY
3p6nq3pw4rw	THE ADDICTION
CXaMFFi8zpI	THE VISITOR
Q3hBLv-HLEc	Stalker
7rIA7MuKz0c	How A Broke Start Up Beat The Movie Rental World
pjiGnh3_5F8	Meadowland
QtflMRe_K64	But I'm a Cheerleader
_DhBgBzlTUM	The Stranger
oBjk4z2-OXU	Mr. Imperium
qpVlNIgjuos	Western Movie
CvQeK_FNxcE	FINAL EXAM
Ok1QwJ4cLlk	The Bloodstained Shadow (Solamente nero)
B-Oayj9quog	Submergence
uJGe9wM6pIE	Stella Dallas
zRavMOxzr_s	The Big Combo
HwEFOD9OwnY	Sabrina
DezU5Ij_fts	The Apartment
lhc9S8txE9c	One Hundred Steps
mvzWeN62XpA	The Wraith
i3U4IQI85Q8	The Red Pony
Bi35RZQkEd8	MEL GIBSON
Z8ZhQPaw4rE	Solaris
2-Nlj3_khBQ	GHOSTKEEPER
aCFQaArAKzI	Violet & Daisy
R3ZiN3nU4zY	The Manchurian Candidate
dGJfkFlQQl4	The Intouchables
2NLT12GAhLk	DARIO ARGENTO'S FOUR FLIES ON GREY VELVET
tFeL7OMnJd8	The Way Ahead
PaE3tNgmGIo	The Longshots
vAp6s4M8r5c	Capricorn One
A8kYJodhYrw	Airplane!
ICZQ6MFpiho	The Meerkats
AGZVx00xMJ4	The Woman in Red
Je8g10Q3-gY	Who Is Harry Nilsson (And Why Is Everybody Talkin' About Him)? (Full Documentary)
0AzziTZ8QqA	Rogue Trader (Full Ewan McGregor Movie)
pYdjix7StNY	Fear and Desire
Sk9Kfp96KjI	Tormented
TPAPORv0R4w	The Southerner
kBfWS0BniJE	A Boy and His Dog
UAjZoynOqxA	My Son, My Son, What Have Ye Done
rZTEaHKmuc0	Ip Man 3
LkW7dIDchzw	Ip Man 2: Legend of the Grandmaster
zGD9OFmxYXM	Ip Man
ZXPlQ-lE8m0	The Ultimate Gift
ICFWrZul-dY	Sin Takes a Holiday
ExGZtlzL1x4	Aileen Wuornos: The Story of a Serial Killer
FjaBBZmz_Vc	The Dark Journey of Aileen Wuornos
flkjrJyBiSg	Watch out for the Automobile
ClqGoLeSRXo	The Woman in the Window
skVFtz8Hlis	Rap Beefs And Dirty Cops: The Biggie And Tupac Story
ZPlFn1Ex3Ww	The Canterville Ghost
HFAhu4b1jog	Blood on the Sun
8gfWheuyVj4	Swing High, Swing Low
zO2-JxMLroE	The Firm
f1ahG3ySyV8	The Hunt for Red October
RVotsp0vSeg	Small Soldiers
mRXSA-WRfvs	LASSIE'S GREATEST ADVENTURE
aHwfPxt_It0	Utopia
IelsblcDX44	On Golden Pond
GyykN8e_WXw	Star Wars Holiday Special
dKOq1jhXQZw	Long John Silver
6ucWqsQj5G8	DEATH SHIP
i2PZI6YTJZQ	Visitors
6xSl5KbFPdA	Sugar Hill
VaxKRU_8cGY	A Single Man
WblnLk387u0	Tom Petty: Somewhere You Feel Free
TpdjMHLN9V8	RiffTrax: Plan 9 From Outer Space (Full FREE Movie)
2Z6IfzcUap8	Jesus of Nazareth
lygLYbSixjY	Dreamscape
L4SZyeUGSM4	Santa Claus Conquers the Martians
x_4UbPGFJjA	Wes Craven's Summer of Fear
qs7B6nlzUZE	Midnight Special
NhMSGYHoeOU	The Neverending Story
XNA-a1AII8I	Kingdom Of The Spiders
jMwfhCT8CSE	Richard Boone Cult Horror
HorOrml6hKg	TO LIVE
PsMCIGd4gBg	The Howling III: The Marsupials
fmMrSNkHM60	Eat My Dust!
ML1Br1w-BsE	Signs of Life
igPrv6LTjKA	Battle Beyond The Stars
Nkh0hY9pAcY	Space Truckers
E5KBjZ87wpw	Munchies
Ux2kLeAc6NI	MS. 45
cg4kZVrzA5c	THE LAST HOUSE ON THE LEFT
StUZdCc6gwg	RED SORGHUM
5rknic8PmWI	Que Viva Mexico
soRIjIJAUfA	White Tiger
7ZJStVRhXtg	RITUALS
PFr6xNgY11k	LEPKE
4jjRPs4bvQs	The Artist
T35jhabPLvg	Grace is Gone
GG8blf-tZmI	The Iron Lady
GCLWK2vEHVc	The Promotion
nKht7iGLhc0	The Dark
AdxL9r3Wx_g	Automata
pRNCYvnt4N4	Alice in Wonderland
zji0fqFbN74	Buffalo Bill And The Indians, or Sitting Bull's History Lesson
FS52QdHNTh8	The Brain Washing of My Dad (Family Non-Ficton Film)
dOmBdHtwjr0	Blood and Black Lace
ULVZyfQ_tz0	DON'T GO IN THE WOODS... ALONE
I4uiQiidXEA	FINAL EXAM
QvOmRoMwgX4	An American Werewolf in Paris
qtqwv2ol_44	Letter of Introduction
odMyrNbw8gk	GEORGE ROMERO'S THE CRAZIES
P3frEdLR_6w	JOHN LANDIS
gGUr7m3WVF0	Stonehearst Asylum
MrmhR_ly1BE	Pitfall
ys5SRIFuzsw	Beyond the Door
-zNDe30_eKw	The Hiding Place
WqjIzyylcoA	Run Silent; Run Deep
ZkRyefRJcHM	Jack Palance Italian Crime Action
dhiSXcu3u-g	End Game
K9TlhQyBc88	The Paperboy
B-8mQWTlLXg	Caveman
6isxjd3dqAU	Left Behind III- World at War the Movie in HD
thlx3EnbolU	Crazy Six
e0NN-TC97sM	The Russia House
bK2a9L6gdu4	I'm Gonna Git You Sucka
6LyHai02R9Y	The Dukes Of Hazzard
IiCbaTkdEGM	Suddenly
z37wCZsyxls	Cell
HZB2_2sJpNY	Paradise in Harlem
wxzXK6MwSQo	Gerry
Td0lOwyHzNk	F/X 2
QtF_1hoXe1M	The Land That Time Forgot
1CVLz1_MrCk	Friedrich Wilhelm Murnau
FegcYaM90f4	Crimson Romance
8ufGPr87G-8	Left Behind 2 Tribulation Force The Movie in Full HD
_Ng0Ii6eFq8	The Slipper and the Rose
40ZMHLZ7Sw8	The Bird With The Crystal Plumage
KdylIez3D2E	RiffTrax: Miami Connection
2QwhdP9Edss	Return of Sabata
ZymFCTI3UGs	The Big Sleep
4Frb4gXCeQA	Another Man's Poison
GwTnJ2bR0yo	The Wild, Wild World of Jayne Mansfield
Z8jZmEKRCf4	O Brother, Where Art Thou?
IIc3CZmbEb4	Short Term 12
CUlcLjBb_Wg	Inferno
ZH1SNmY_1XY	RiffTrax: Birdemic
D0YbW0ZzaNQ	The Scarlet And The Black
kMJREjZOsGI	Borderline
e4lz3h5Ofj0	Crocodile
01bGNOact2Q	March Or Die
m9V0-K8WWk8	The Ron Clark Story
y1RxVTBWKrw	Voyage Of The Damned
GZ0CaF5nw20	The Kids Are Alright
wxfiQQaESXE	Escape To Athena
2DrUd0BbcRU	The Wendell Baker Story
7fG5ftdarg4	Saturday The 14th
KoCayBviN-o	Space Raiders
EbVm_uTYQZQ	Welcome Home, Roxy Carmichael
gBlLHju2fvU	A Handful of Dust
3KasqdsIaIs	Millennium Actress
Tyub_LK3sb0	The King
ZJ7IzvlKNy8	Rampart
KPKeYhkBt5A	All Quiet On The Western Front
mUkZ5gWsAqE	Griff the Invisible
lI9x9cKpwHc	Outsourced
-8EJ9uhsfQQ	The Jungle Book
57YMa7kaZCA	The Contract
UgAojBDzPqQ	THE LAST MOGULS: Golan & Globus of Cannon Films in1986
EVW1MRS6jsk	The Package
Y_u6mtxQ48M	Terminator Salvation
VKcmwFTlhRs	Juice
CpgiEg4Vqsw	Teenage Mutant Ninja Turtles
xxkC_UGiDHM	Invitation to Hell
km34VlpCezw	Truman
-2z8CxB_mPM	Rooftops
MAFFFQan-oI	Nothing but the Truth
nMIRhYTkjpM	Jay Sebring....Cutting To The Truth
o1EX5QIYID4	Lars Von Trier, Woody Allen, and Martin Scorsese On Bergman 
GulJoaXpuRM	Winter Passing
rJDfzLApXzQ	Haute Cuisine
nhSH9egIMtw	Trust
vnf2eaSTDuA	The Accidental Husband
jvG5VMn9KX0	Cassandra's Dream
Pe8W2IhEG5Y	Eva
hQKPnEXN2gU	School for Scoundrels
GifTacP8TqM	Street Scene
LiDQPn_LziA	Hook Line and Sinker
_oo6zXjriI4	Millie
2nQ0eeoXfao	Carter's Army
vO5vDc9Y7aI	The Fugitive Kind
ybbI934AduU	The Defiant Ones
VZ9M83hdWi0	Molly and Me
dEqa-pQa-WA	The Hairy Ape
-tiqoH1iKG0	The Mask
PT02T3kXDJY	Clue
fmJuaReRV9I	Frauds
rqxeJI51tkk	Resurrecting The Champ
ePA-Tg4sJf8	The Maiden Heist
mvcUvr2FATc	Beautiful
tYEdf2Ftnxo	Sweet Country
bPQD0VuD7K0	The Rage of Paris
k-ImAugEJzg	Our Town
ug4rvXu4yCQ	Fido
tUcKL5ZBxYQ	Love & Mercy
a11dSfxv8Vs	Death Defying Acts
k3tOREQ8uYo	The Grandmaster
LckXeIlNXuw	Tora! Tora! Tora!
YH5Abr9Lwkc	Cheers for Miss Bishop
KunQC6a6fPU	The Illusionist
Ss7lc5kB0BY	Mother India Full HD Movie
PXNexledaPk	Sita Sings The Blues
zRAB5WzicfU	Breakheart Pass
M91qbp_SNvI	The Mechanic
8P-jpaybw8A	Mr. Majestyk
lsCLMPLlVdU	The Battle Of Britain
27m7hFtDakk	The Dirty Outlaws
bdCWmuNCxHI	MADMAN
pnpHneH4o6s	Of Human Bondage
I5p667c5D14	Dolemite Blaxploitation Action
ZBatMxjZbjc	Guilty of Treason
aUA9uC9cUqE	Listen to Your Heart
vcsSc2iksC0	Life in a Day
SoRoMykmibE	Zero Days
zmNMg5poJZE	The Inglorious Bastards
4kgZd8jeVyQ	The Night of the Hunter
I3xds0UqREE	Lucky
xp8vARYNAMU	Duel at Diablo
I357pyTH4YA	The Mandela Effect
Lih7_P_hdNg	Charlie Chaplin, Jackie Coogan Classic Silent Drama
KuWodvha5XU	They Call Me Jeeg
jf2gOSORoqU	Jab We Met
mTN9h9-e7NE	The Blood of Jesus
8uEwGmjhquU	The Plow That Broke the Plains
rZ3qApMOwxs	To Save A Life
WGTlO_GO29I	Raging Bull
KRNbbNBGaj0	Support Your Local Sheriff
ANrXC2HArXA	Cooley High
OEXzslm0ru8	Night Of The Comet
EwjQFjyzpVU	Anita: Speaking Truth To Power
7lbg_FKuQtw	Dillinger
n1wTf4xmwzY	King Solomon's Mines
tgaF7taD-rk	The Island Of Dr. Moreau
6lCCk6rgn84	Pumping Iron
hgR3xEm3Szw	According to Greta
IkbeK0kWR4s	The Bible
OoQCPkYAQTI	The Family Fang
td9SJxbLkik	She's Funny That Way
WsWZkEMF9LM	Little Italy
-S-3j6nShgM	All Of Me
B0BgpYtssjg	The Edge
mSUWMX5-K3U	Romance Drama
-5ROjuzpPoQ	Tangerines
FrtZEYgcaIk	The King's Choice
ee6YLTK5OEM	The Longest Week
dDx9J9cFPBY	Samurai
B5q_Ly-Dl94	Santa Fe Trail
Ae7ZwBfw7GE	Freddie Mercury: The King of Queen
6y3n6UN9jtM	Sonny and Jed
18WSTwGwIZ8	The Inspector General
pgGpFGf6RGo	L'Amore in Citt√† (Love in the City)
I1ktthVGAoM	The Vikings
s17nN_CX4_c	The TV Set
wnSN6SAsQHs	The Cross and the Switchblade (HD)
gXxNDASp8_w	The St. Louis Bank Robbery
HIq52dmyJFA	Watching the Detectives
tjPd7R-1n0s	Elmer Gantry
Kiw4CR5jmtY	Stigmata
JaqMhG3KFtU	OUR HOSPITALITY
GWmULjZDjMI	Cary Grant Classic Drama/Romance
L3QliwOgLV4	Algiers
XULA_eWzLvA	Full Movie: Saints and Soldiers
zd6w_xBRE3w	Tickling Giants
5eYUrgV4ONc	Martin Luther
2PhTfgr6DsE	The Lady Refuses
zvAFPHLFMa0	Inequality for All
6c2JhrmSZMo	My Dear Secretary
SS2Kezl0EZ4	The Front Page
ZlXepUKmGCg	Sabata
EjZ_8WGb0fg	The Alamo
CuPzKwoqp3A	The Delta Force
Rgl2rc1NLOA	Man Of The East
0sZGyYeAAaw	Gator
-FNzjrls0WA	White Lightning
d2AK4G5sn5E	The Mighty Quinn
6Uv4-iJqLxQ	Invasion Of The Body Snatchers
MXhPrQbZQgQ	Where the Red Fern Grows
vnR47T7f6_8	This Must be the Place
s8a4fiqfADU	A Thief In The Night
2a6SLuVtiVU	The Square: Egypt At War (Oscar-Nominated Documentary)
TfR0eUy-hnc	Jabberwocky
-veB5E9OPR8	Bats
CVU_Xu_AXNQ	Undelivered Letter (4K, drama, directed by Mikhail Kalatozov
FEO7aOZnRwQ	The Tillman Story
JV4g58fJVbI	And Soon The Darkness
-rlOZN10otw	Mutant
qA8I7gpmfTg	Sarah's Key
7H4uz2Fq24Y	Mr. Church
3ZOV4YhquXI	Meet John Doe
ApEh9Sm4BR0	Stanley Kubrick A Life in Pictures
wOg0TY1jG3w	The Real Story of Paris Hilton
C4RRNakRE-c	Shadrach
lLsscnqlUnI	Dudes
oXtVGLhg_Tw	Beyond the Sea
L7ti8qvi_8I	The Spanish Earth
BawUDjjgAsc	Black Christmas
moE3VwMo7QY	Away From Her
oSUcStCOU0Y	Allan Quatermain And The Lost City Of Gold
YP4o_Cf7ubM	Tank Girl
-_VXZbPfpK0	Incident at Loch Ness
sK96XRYmhcw	Valdez is Coming
He3IJJhFy-I	Social Media Dangers Documentary ‚Äî Childhood 2.0
NTcHza--nVs	Family, Western Movie
bkIzwKlSU04	Rudy Ray Moore Action/Comedy
f9RGUlvrog0	Rob The Mob
DsbFW_d6J6M	On the Record
XQGyHCfxOcQ	Lonely Wives
rehNT9wIjUg	Gulliver's Travels
Bb15oTBRlUQ	Infinity
NOY3krsCjU4	Avenging Angelo
PPyQsd9mJ1o	The Pride of The Yankees
j7dLRznAJ4o	The Missouri Breaks
hVhxuKFzc7s	The Madness of King George
PpJl3IYeo5I	Lawman
1IAC5y_j3LA	The Killer Elite
E21mHnQYu8w	Brannigan
zge7WwormtU	The Magnificent Seven Ride!
IXCqOjxjtYc	Witness for the Prosecution
SZlGv6XsZuc	The Killing
2QjKJN9D7as	Article 99
PwJGocr0n9I	The Yellow Handkerchief
wIfL5noCef8	The Battle of the Sexes
5B7VXzGmacE	My Scientology Movie
FNp-xhmjuJk	Viva! Django
czCswMQOjCs	Guys and Dolls
oPvsKsCBYds	The Secret Life of Walter Mitty
OFS8SpwioZ4	CRIP CAMP: A DISABILITY REVOLUTION
s_WvTBP7G7Y	The Last of the Mohicans¬†(1920) Action,¬†Adventure,¬†Drama¬†Silent Film
C6lB9HQnSac	Crime + Punishment
2PaAbmRJ9bQ	I Am Not Your Negro
ViFmRQx66Xg	The Man Who Skied Down Everest (Oscar-Winning Documentary)
q5mPY_iTAhE	Silver Lode
ullJoBolcqE	Dr. Jekyll and Mr. Hyde
1pitdqUuK2I	MJFF Virtual Cinema: THE SCARLET AND THE BLACK [FULL MOVIE]
09w7isSx650	House on Haunted Hill
yyV2UtHoDWs	Bluebeard
HF0Tz7cMQpU	THE MASK MURDERS (aka Alice sweet Alice) üé¨ Full Horror Remastered Classic-Movie üé¨ English Movie HD
KHrEQGU3LVo	KON-TIKI
zGQoS3c30WU	Stories We Tell
pabSPPBKDw4	Nine
CUCjCn9HDyc	The Red Violin
a159xGKsDvg	The Magnificent Seven
oruKFJt4ZIQ	Force 10 from Navarone
ssnVutpE-mE	Touchback
Bln5x9hKa0g	Love and Death on Long Island
kRzmxox0L0k	A Bridge Too Far
Xrx9rOuWH1U	Picture This
yMcCjwgwVys	Tracks
xZeMB8rbDAs	The Phantom of the Opera
OMmxSELuP-8	Little Lord Fauntleroy
N1lSTjClKfs	Secret Origin: The Story of DC Comics
JpPAN6frZmU	Roger Corman
q3g3hqNJqpQ	Lo and Behold, Reveries of the Connected World
mVVf6Zdxifw	The Screaming Skull
3m9Vtbahhgo	Crazy Love
SbTB9AILOkw	Madame Bovary
vZI6A5z7SBY	The Babysitters
hdmm4m3ft3Y	Strong Island
AJaHhDqrI_Q	Comedy, Family
e-aT8Wt2zBA	The 51st State
EMvIgNcej-w	Blitz
MXpgrN33OrY	Bigger, Stronger, Faster
atO8N4qsda4	Control
_j-zKSiezvA	Southern Comfort
IP1xlXj76Mw	The Gorilla
fHOGU6EWcKg	A Matter of Faith
td3OM8jbBJQ	The Bat
AYLDF9MK-9k	Becky Sharp¬†(1935) Miriam Hopkins, Frances Dee
UepbwNjmSJY	Quicksand¬†(1950) Mickey Rooney, Jeanne Cagney
oOfsFElKfNY	Broken English
VXNWzpkF0ak	The Flying Deuces¬†(1939) Laurel & Hardy
pCIRmVKxESQ	Superman
9_LfFA8m3u8	GASLIGHT (Fully Closed Captioned)
2P_6Rpj75aE	American Ninja
bQSJynTgVvg	Second Glance
aW6yN-02vVs	One Dark Night
g3auIIGvgk0	McLintock!
-k0D_qFPb4o	The Gospel of John
MNRSxu22NxU	Film-Noir
FvRbFnPQDpI	Hell's House¬†(1932)¬†Bette Davis
0J0RFoHGFtY	Cyrano de Bergerac¬†(1950 Adventure)
Zk11vI-7czE	Michael Moore Presents: Planet of the Humans
YCSo2hZRcXk	Knock Down The House
aGGBGcjdjXA	Chasing Coral
fQM6t1oSQkE	The White Helmets
krfcq5pF8u8	13TH
vNYg4YWkp0k	Carnival of Souls
HRMI21dH4pU	Afterglow
5nKLzD2QZS4	The Patriot
Wy1EdvObQb8	The Great Gabbo¬†(1929) Von Stroheim-¬†Drama,¬†Musical,¬†Romance¬†Film
NV3B2z0HkKA	White Zombie¬†(1932) Bela Lugosi
jjwilAja7Lc	Coachella: 20 Years in the Desert
E7HYZeQC6Mg	The Delinquents
eMZpYwx1tjw	Passion Fish
ct5UvaXZrxY	20,000 Days On Earth
z2vGzImfw9Q	Life of a King
fzfMsnqD-yM	Survivor
qMdY_wUqAI4	The Dungeon of Harrow¬†(1962) Horror¬†Genre
aN5qrz28etw	Bird of Paradise¬†(1932) Adventure, Drama, Romance Full Length Film
gntDkYfJwj4	Grand Theft Parsons
N3Pzv6RB9iU	INDISCRETION OF AN AMERICAN WIFE (Fully Closed Captioned)
CZBqbE_Ybk8	Delirious
okJs1N6eaPA	Cherry
b6IHTBMwCkY	My Blueberry Nights
POOxe1jvKoE	Emperor
XH7UJtqiKdE	Bloodsport
Co_6dLsL_-s	Rabbit Hole
JWdjUvPT-CA	Bandits
TH-ep4nCNWw	Casino Jack
SzSZ9B31ZcQ	The Strange Love of Martha Ivers (Film-Noir
fMlGHGK62mw	Horror, Sci-Fi, Thriller Movie
rJW_C5YO7aU	The Red House
WGyEelzJaMs	Kansas City Confidential
hKmGUIM1uAI	Muscle Shoals
2uU9qeFFQ90	The Ten Commandments
peKw-1VsCdA	Frightmare
1WHakpvHF6k	Detachment
7eTI1qbKFK0	The New Daughter
LUpnFNUmfKw	Capitalism: A Love Story
cCvyYxa18ow	Drive
kaPLWHN8TsY	Half Light
6mns2dXHqw0	Frozen
iHil4Y4r3Wk	Ghost in the Shell
n1RjFprRsFs	The September Issue
bEFD3nq71Ec	Before We Go
ceRFvhlcsiY	Fed Up
2o3Lgx_HSRQ	Cube
NRzDsxUOm4M	Citizenfour
VumP4csBt_M	She-Devil
H_8nq87Om5I	Once Bitten
LFsdU3orNYQ	Hedy Lamarr
dSyicDf9UvI	Super Size Me 2: Holy Chicken!
-xhX2o4OY6k	Straight A's
-gAOaYPxeD4	The Double
oELEgxBYmA8	Remember the Daze
ZFjnK5Nx-II	Forever Strong
4LCtzLEebBI	HORROR EXPRESS
EzQXH3UTD7U	The Lazarus Effect
VMlZSQuJRV0	The Mercenary
5UmqzBuVu3A	Blown Away
y-5ZHTzd1hQ	Blue Steel
dh_vmhtibmo	The Glass Menagerie
VIdrqrIomdM	Cut and Run
ImNmTjLAsG8	Party Girl
QUNmkNADLBQ	Bernie
maF1LQlWDdo	Trumbo
4kla_bxt2NE	GAZA STRIP
NCf-rMTmFRM	IRAQ IN FRAGMENTS [2006] by James Longley (full movie
jOJzltLT2Zs	Purple Rose Of Cairo
3RlB9NiNGr4	The Asphyx
25lFvy2YPSo	Fear X
nXfT0N6m2XE	Custer Of The West
utsU6ZVfHF8	Christmas Story
taCiORGHPZE	Day of Anger
44zZ2dPS4ao	Full Movie
OMF54QW4Gtc	Mr. Mom
7b2CZd2UDsI	Road House
zpv8ycjfIYI	Troll 2
PtgyLuwlkjA	The Hellbenders
0SASZaT7lI4	Star Wars 
b1knAiEbtoE	Anatolian Eagles
NQjyQACnz6I	In Hell
k91gP7u3fhs	Atlas Shrugged
ZIjCyULA0wM	Atlas Shrugged: Part II
BnNcOl31WOk	BABES IN TOYLAND (Aka MARCH OF THE WOODEN SOLDIERS
B7HM7XnSx5o	Killing Season
5fUbNZWO4gI	Some Guy Who Kills People
GXF2zw2UOe8	Sugar Mountain (Free
HdFKZtZop7A	Perfect Bid: The Contestant Who Knew Too Much
9UoeFfHA8y0	Already Tomorrow in Hong Kong
LQJHN4gIj9w	A Little Bit of Heaven
7oQ-HkAwYi4	Red Lights
zq8TuNWFl4g	Transsiberian
uutYyiJqmpQ	The Proposition
H24GyolFC9g	Ernest In The Army
JMvuVUpdx-k	Manny
rU5A_wUzpz4	Ernest Goes To School
hZnuc-Fv_Tc	Requiem for the American Dream
5cMVNtmbwyo	The Gift: The Journey of Johnny Cash (Official Documentary)
ezNqSAIJIOI	THE OCCUPATION OF THE AMERICAN MIND
wFt28GPi0_8	The Intense And Dangerous Training To Be A K-Pop Star
yE2zRHNSsDU	A Chorus of Disapproval
MlqJs7-GRhY	The Iceman
Yaddtzzmge8	James White
hFCvHknA41w	Mermaids
1b2WNNXhlOI	Eight Men Out
8TNdihbV5go	This Man Single Handedly Stopped All Out Nuclear War
yPY1FtiPyZM	The Internecine Project
0uNsvALpEVw	American Perfekt
85UxL-AJdpQ	Ninja
ENCieEZkoP0	New Rose Hotel
j0UeCIGeO5g	Zebra Lounge
R8OLWxPerNU	Guncrazy
gOVIjKvOcE4	War Requiem
u0kR-2HAsMM	The Hidden Empire: An Investigation Into US Military Dominance
Q8Gt-UqwZaI	Biggles: Adventures in Time
f3c3_2GO8fQ	Absolution
TU_t60Ty3F8	Lone Wolf McQuade
la-J5K_dJA4	The Prisoner
FEAq7D4cOno	The Legend of the Red Dragon
xedSF-s-q2E	Desert Blue
4yDkoKoZdXY	NICOLAS CAGE
aLnQgjQFLCI	The Proud Rebel
7OVo0asgvAk	A Gathering of Old Men
1Ioc7q_26tE	Howl
y-z2fjhUPg8	Black Joy
og2K-c7nNsg	When Eight Bells Toll
cZi_q9fwQfg	Street Fight
fFwX8lBiMJI	Man of Violence
36QLKu4NA18	Jack's Back
BTxvtrn71aI	Nomads
BE7YjbpEHV0	Scum
lofR1HO_c70	A Field In England (Free
wYpETOHjrJ0	Air Guitar Nation (Free
aHpqWC_F3w4	The Kovak Box
HSSkoxv239s	Pakeezah (HD)
tn63Ip1T5Gk	A Map of the World
mTgcKPspE9s	Ticks
SNr71oGoZC8	That Sugar Film
-Eo7J7u-uCU	Priceless
GDbsj1oW_Fs	Saint Ralph
KlMeMaMLKYI	Thelma & Louise
MtM0aLf-bPs	Little Fish
zKQGAv8gtBA	Super Size Me
o7RpSvi9Hy8	Tortilla Soup
mHrk4yPEj0Q	Lightning Jack
_YCLxSHVwLA	Puncture
SIKhw41Ec28	Eye See You
OM6F29N4Jmw	Wiretapper
MkNuvmFqV4M	The True Story Of Jesse James
n4OBfwefnqM	Life and Passion of Christ
4TDTQUGkJ1Q	Platoon
Q1B3AOCcTKE	The Bloody Brood
wv3_ly8r02M	Ro.Go.Pa.G.
awXn-EHhC_w	Dances with Wolves
ltlbPX20tr0	A Little Trip to Heaven
ADqEJ9LePcs	Ronin
0_kA86VJ5sE	L' Oro di Roma
ltfy-jLaV44	WESTERN Movie: Burt Lancaster in VENGEANCE VALLEY [English] [Full Western Movie] [Free Classic Film]
uxOmYaPAdbE	The Royal Bed
L_-tIgyFWwc	Dahmer
CcCRs0Ic3FI	The Boy Band Con: The Lou Pearlman Story
sPxBCu8kNJE	Valkyrie
n-XfagAzwHM	Bulletproof Monk
u7AO7MscMnc	The Rage: Carrie 2
7vtBsKPokHs	Much Ado About Nothing
ttCUfDtrYlU	Andaz Apna Apna
DfMPAPdFEjE	Forever Mine
GYBuoluCIGs	White Fang
NTG2PESRurY	Masters Of The Universe
1VA0t6A4mHA	Rock-A-Doodle
Y8Gd0OMDFRU	PATTERNS (Fully Closed Captioned)
1SxNm40dWzI	O.C. & Stiggs movie
KuDI2O4Nyw8	NOTHING BUT A MAN (Fully Closed Captioned)
jGmD38qe7Fw	Baby Boom
UsqKz1hd_CY	The Price of Free
dUAqyynVEGQ	Banana Joe
-mxp8Eac4QY	Hollow Triumph
qRqwLrZKDw0	Go For Broke!
feQ3-DuzS-Y	The Emperor Jones
i1m9OOPFxfI	Margaret Lockwood Adventure
AeDFAkCzwKI	Dixiana
5fK1pZ38lqw	The World's Fastest Indian
FBSQ1e5Ksn8	Shatranj Ke Khilari
hRpySnuJfus	The Assassin
X6594DTlx5c	Double Trouble
RGFgPPI0DXM	British Comedy
vrsG-1FAp78	Bio-Dome
3vRr-A-_j7E	Sleepover
yk9mZAJY9g0	Out of Time
5T_CqqjOPDc	Hackers
T80N0qdH18s	The Perils of Pauline
3rIaW1uCrLk	The river
7a0tXDkvfG4	Judith of Bethulia
f2FyD3RZGi4	With these hands
ZNApFyTeSKg	The Milky Way
KwzhUFfAAxw	That Uncertain Feeling
N_dnqe4U3P8	The Silver Horde
RCZazaWHh3g	Mars Needs Women
mWrUkedi2oQ	7 Days In September (16:9)
7HYYhQwYZEE	BAFTA-Winning Mystery Crime
9eQXD_44Kso	King In The Wilderness: The Last Years of MLK Jr.‚Äôs Life ‚Äì Full Film
1ymDte0gjqM	Odds and Evens
gyePJXDB-uQ	Gregory Peck Comedy
wuyZu6fi14s	Three Guys Named Mike
ITVbGJ0Unn8	Peter Sellers Crime Thriller
KYLDMLFBWeo	Go For It
Vwbf-WJZWWs	The Killer Shrews
vcOAS0ylQv4	Claude Rains Historical Drama
ahwG5Q_05-k	Night Tide (Fully Closed Captioned)
6FqUN9MO0zc	Bhagam Bhag [2006] Hindi Comedy
YG85RGawkDY	Parlor, Bedroom and Bath
BR4-PADx-V0	Omar Sharif Spy Romance
tEQjqAEXHOQ	Captain Kidd
OeijnOSedPs	Navy Blues
aVH7D2fgtoA	The Great Flamarion
n1DgmyB8MIA	Death Rides a Horse (Classic WESTERN Feature Film, Movie in Full Length) *full movies for free*
QX3M8Ka9vUA	The Third Industrial Revolution: A Radical New Sharing Economy
ZmE6TN9bYQg	Golmaal: Fun Unlimited
rRpaPV3QayY	Sadgati
GB4NOdy9rRI	Lisa and the Devil
dMTHwuQnIKA	Jew S√ºss
DW4F_ZMrS3A	The Memphis Belle: A Story of a Flying Fortress
I2djFnp5h0w	All My Babies
fE00fzXpI04	The Cry of Jazz
VcKZ636kvxg	The Hitch-Hiker
Q6TQEoDS-fQ	The Middleton Family at the New York World's Fair
GQntuOeDbqU	Adam Had Four Sons
ZWTlL_w8cRA	Demi Lovato: Simply Complicated
deEuVTAAzbg	The Autumn Marathon (HD)
nypP4MX7KVs	Inside The Bubble
quO_Dzm4rnk	RiP: A Remix Manifesto
P4k2LNPRV-0	Mimino
4naOrjRiTnc	–ñ–µ—Å—Ç–æ–∫–∏–π —Ä–æ–º–∞–Ω—Å. –°–µ—Ä–∏—è 1 (FullHD, –¥—Ä–∞–º–∞, —Ä–µ–∂. –≠–ª—å–¥–∞—Ä –†—è–∑–∞–Ω–æ–≤
UEDed0o7FYs	Old and New / General Line
DRuPHt-rE7U	Arsenal
mSfXW15bWCk	Three Songs About Lenin
sCE5447sjQY	Storm Over Asia / The Heir to Genghis Khan
YVuf3T3k-W0	October (Ten Days that Shook the World)
BfUu9wMvypo	Volga
cGYZ5847FiI	Man with a Movie Camera
A-E57eyjoao	Earth
b7948xMbylU	Detour
OeQJAt521-I	By the Bluest of Seas
FVAN0A6OWE4	The Circus
duy1k7lCvjA	Pot o' Gold
y3jrB5ANUUY	"The Great Train Robbery"
mkvZxT5hd84	Il Bruto (El Bruto), Luis Bu√±uel
at-xnnNT8N8	Land Without Bread's
aVnu4qAiK8Q	STAR PACKED CHRISTMAS! Noel
3OLJZvgIx5w	The Battle of San Pietro
wRs4Y3Kzdt0	Little Nemo: Adventures in Slumberland
ai9WXoceaVI	Dreams On Spec
blwiQYfQBYU	Honeydripper
PvG8y3bNmgg	Chunhyang(2000)
0S2i-b1Rrjg	The President's Mystery
DZbWlqDTq88	The Forgotten Pistolero (Gunman of Ave Maria)
vdb4XGVTHkE	HUMAN Extended version VOL.1
PbtmICspboo	The Beast of Yucca Flats
JQ43h-gWZ6Y	Mon oncle Antoine
ku9edEKvGuY	Anonymous
PtK3QsFpm6M	The Forgotten Frontier [Silent] (Frontier Nursing Service, Inc.
RXmnBbUjsPs	Walmart: The High Cost of Low Price ‚Ä¢ FULL DOCUMENTARY FILM ‚Ä¢ BRAVE NEW FILMS (BNF)
GjsFAZWnA00	The Empire Strikes Back Uncut
gpvcc9C8SbM	Anonymous
8TjGAWxL23c	Plagues & Pleasures on the Salton Sea
WwZoUX3CxXE	It Came from Kuchar
R3UzzbCqHf0	Queen Kong
9ifDqlRZh70	The True Glory
UjZYMI1zB9s	Free to Play
HGezagpjZiA	Street Dreams
oeWdw1ZTaxU	I Cover The Waterfront
gPf0p6C7GiQ	Little Men
Cq3FJqy7w1A	Hitler's SS: Portrait in Evil
E80gECY4kcU	The Forgotten Village
5fbvquHSPJU	Four Horsemen
qLCtGDvkT_I	They Made Me A Criminal
Wt7eedQCDQY	Indestructible Man
t_bNDDM5ABQ	Cause for Alarm!
lQPoYVKeQEs	Let There Be Light
Gm5durVHxIw	Captain Scarface
31WEBwFpULg	The Fourth Dimension
dgIZZfG22wQ	My Favorite Brunette
i12seZ6KlhE	Borderline
DR-OkcqI8NU	Father's Little Dividend
SosQdd2eb1E	Smash-Up! The Story of a Woman
fypOpzikhDA	Sherlock Holmes THE WOMAN IN GREEN
BNk6gSdllks	America the Beautiful
KpzIen5udo4	Meet Bill with Aaron Eckhart, Elizabeth Banks and Jessica Alba
TWUhu0l2srE	Mulberry (Ppong)(1985)
RBB06RLmCcU	@DavidCobham presents JACK LONDON's "TO BUILD A FIRE"
o-o2JHhHXys	JESUS
eSGkZhhnuWo	JAMES DEAN: BORN COOL
xWBsKDLzq20	Clear Sky (drama, directed by Grigory Chukhrai
5YzwW4hxrx4	Scarlet Sails (4K restoration, drama, dir. Alexander Ptushko
oqz0x3TH2no	Disco Dancer
Ll1Wdob2P1E	–ê–≥–æ–Ω–∏—è, 1 —Å–µ—Ä–∏—è (–¥—Ä–∞–º–∞, —Ä–µ–∂. –≠–ª–µ–º –ö–ª–∏–º–æ–≤
0UuaJPGee20	Diary For Timothy
JaFVr_cJJIY	Life In A Day
yJTVF_dya7E	1960: "Harvest of Shame"
jqxENMKaeCU	HOME
6eJ6AlzC4X4	"Black on Black" (1968; journalism professor Joe Saltzman)
HaQafuDw7kU	Wicker Park
rbD6CAzj7lg	The Blob
gusKTPFXT3w	The Stone Killer
5jzaxoY0PGw	Mr. Deeds Goes to Town
e6_bLUc0VLQ	Snake In The Eagle's Shadow
jEzEJYNXU-4	The Harder They Fall
CX_WIXSyMF4	The Triplets of Belleville
uNYRjk1eEGY	The Wrecking Crew
mgS2TgbI7_g	The Long Ships
uhxxGDcWWoc	It's a Mad Mad Mad World
